continuation,Node Path,V Score,H Score,G Score,F Score,Temperature,Max Tokens,Wrong Solution Flag
" 1. We need to find out how much the truck will weigh with the maximum possible load of boxes.
2. The driver and the empty truck weigh a total of 3755 pounds.
3. Each box weighs 15 pounds, and we want",Node0,2,8,2,10,0.6699426360304815,56,False
" 1. First, let's identify the important variables we need to work with. We have the bridge's capacity (5000 pounds), the combined weight of the driver and truck (3755 pounds), and the box's individual weight (15 pounds).
        2. Next, we want to determine how many boxes can be loaded before exceeding the bridge's capacity. We know that the current load on the bridge comes from the truck + driver + boxes.
        3. Now, let's set up an equation",Node2,2,7,2,9,0.7671607454091812,114,False
" 1. First, let's find out how much the truck weighs without any boxes or the driver. We know that the combined weight of the driver and the empty truck is 3755 pounds. So",Node5,2,10,2,12,0.166341368558227,44,False
" 1. First, we need to find out the total weight of the boxes. We know that each box weighs 15 pounds and there are multiple boxes involved. To calculate this, multiply the weight per box by the number of boxes.
           Total",Node6,3,10,3,13,0.4595834720606795,53,False
" 1. First, let's identify the important variables we need to work with. We have the bridge's capacity (5000 pounds), the combined weight of the driver and truck (3755 pounds), and the box's individual weight (15 pounds).
        2. Next, we want to determine how many boxes can be loaded before exceeding the bridge's capacity. We know that the current load on the bridge comes from the truck + driver + boxes.
        3. Now, let's set up an equation 4. Weight of box = 15 pounds (each)
        Total weight of boxes = Number of boxes * Weight per box

        Let N represent the number of boxes to be loaded onto the truck. Then, the total weight of these boxes will be:
        5000 pounds (bridge capacity) -",Node7,1,9,3,12,0.877294553159112,68,False
" 1. First, let's identify the important variables we need to work with. We have the bridge's capacity (5000 pounds), the combined weight of the driver and truck (3755 pounds), and the box's individual weight (15 pounds).
        2. Next, we want to determine how many boxes can be loaded before exceeding the bridge's capacity. We know that the current load on the bridge comes from the truck + driver + boxes.
        3. Now, let's set up an equation 4. 
        (Total_weight_on_bridge) = Bridge_capacity
        ((Combined_driver_and_truck_weight) + (total_boxes * box_weight)) = 5000",Node8,1,9,3,12,0.7789958434660083,49,False
" 1. First, let's identify the important variables we need to work with. We have the bridge's capacity (5000 pounds), the combined weight of the driver and truck (3755 pounds), and the box's individual weight (15 pounds).
        2. Next, we want to determine how many boxes can be loaded before exceeding the bridge's capacity. We know that the current load on the bridge comes from the truck + driver + boxes.
        3. Now, let's set up an equation 4. (bridge weight limit - combined weight of the driver and empty truck) = weight of all the boxes
         5000 - 3755 = total box weight
         1245 = total box weight
        6. Now, we need to divide the",Node9,2,8,4,12,0.9239128896154514,59,False
" 1. First, let's identify the important variables we need to work with. We have the bridge's capacity (5000 pounds), the combined weight of the driver and truck (3755 pounds), and the box's individual weight (15 pounds).
        2. Next, we want to determine how many boxes can be loaded before exceeding the bridge's capacity. We know that the current load on the bridge comes from the truck + driver + boxes.
        3. Now, let's set up an equation 4. The total weight of the truck + driver + boxes = 5000 pounds (bridge limit).
        5. So, the combined weight of the truck and driver is given by 3755 pounds. We can rewrite this equation",Node10,2,9,4,13,0.6071119131163167,53,False
" 1. First, let's identify the important variables we need to work with. We have the bridge's capacity (5000 pounds), the combined weight of the driver and truck (3755 pounds), and the box's individual weight (15 pounds).
        2. Next, we want to determine how many boxes can be loaded before exceeding the bridge's capacity. We know that the current load on the bridge comes from the truck + driver + boxes.
        3. Now, let's set up an equation 4. The combined weight of the driver and truck (3755 pounds) + the total weight of all the boxes (x * 15 pounds per box) = the maximum load on the bridge (5000 pounds).
        5. Let x be the number of boxes we want to add. We can rewrite this equation as: 3755",Node11,2,8,4,12,0.37291175484635963,78,False
" 1. First, let's identify the important variables we need to work with. We have the bridge's capacity (5000 pounds), the combined weight of the driver and truck (3755 pounds), and the box's individual weight (15 pounds).
        2. Next, we want to determine how many boxes can be loaded before exceeding the bridge's capacity. We know that the current load on the bridge comes from the truck + driver + boxes.
        3. Now, let's set up an equation 4. Total weight on the bridge = Bridge's capacity (5000 pounds)
           = Weight of driver and empty truck + Weight of loaded boxes
           = 3755 pounds (driver and truck) + Boxes * 15 pounds (each box weighs 15 pounds)
        5. To find the maximum number of boxes, we need to solve for the number of boxes (let",Node12,1,8,3,11,0.3890319779503947,88,False
" 1. First, let's identify the important variables we need to work with. We have the bridge's capacity (5000 pounds), the combined weight of the driver and truck (3755 pounds), and the box's individual weight (15 pounds).
        2. Next, we want to determine how many boxes can be loaded before exceeding the bridge's capacity. We know that the current load on the bridge comes from the truck + driver + boxes.
        3. Now, let's set up an equation 4. Total weight (bridge capacity) = (combined weight of truck and driver) + (total weight of loaded boxes)
        5. 5000 pounds = 3755 pounds + (15 pounds/box) * number_of_boxes
        6. Subtract the combined weight of the truck and driver from both sides to isolate the term with the box weight
        7.",Node13,0,6,2,8,0.38119916967289835,87,False
" 1. First, let's identify the important variables we need to work with. We have the bridge's capacity (5000 pounds), the combined weight of the driver and truck (3755 pounds), and the box's individual weight (15 pounds).
        2. Next, we want to determine how many boxes can be loaded before exceeding the bridge's capacity. We know that the current load on the bridge comes from the truck + driver + boxes.
        3. Now, let's set up an equation 4. Total weight (bridge capacity) = (combined weight of truck and driver) + (total weight of loaded boxes)
        5. 5000 pounds = 3755 pounds + (15 pounds/box) * number_of_boxes
        6. Subtract the combined weight of the truck and driver from both sides to isolate the term with the box weight
        7. 8. 5000 - 3755 = 1245 pounds = (15 pounds/box) * number_of_boxes
        9. Now, divide by 15 to find the number of boxes
        10. Number_of",Node15,4,8,6,14,0.6073138101073038,59,False
" 1. First, let's identify the important variables we need to work with. We have the bridge's capacity (5000 pounds), the combined weight of the driver and truck (3755 pounds), and the box's individual weight (15 pounds).
        2. Next, we want to determine how many boxes can be loaded before exceeding the bridge's capacity. We know that the current load on the bridge comes from the truck + driver + boxes.
        3. Now, let's set up an equation 4. Total weight (bridge capacity) = (combined weight of truck and driver) + (total weight of loaded boxes)
        5. 5000 pounds = 3755 pounds + (15 pounds/box) * number_of_boxes
        6. Subtract the combined weight of the truck and driver from both sides to isolate the term with the box weight
        7. 8. 5000 - 3755 = 1245 + (15 pounds/box) * number_of_boxes
        9. Rearrange the equation to isolate the number of boxes
        10. (1245",Node17,3,9,5,14,0.9038694444235368,59,False
" 1. First, let's identify the important variables we need to work with. We have the bridge's capacity (5000 pounds), the combined weight of the driver and truck (3755 pounds), and the box's individual weight (15 pounds).
        2. Next, we want to determine how many boxes can be loaded before exceeding the bridge's capacity. We know that the current load on the bridge comes from the truck + driver + boxes.
        3. Now, let's set up an equation 4. Total weight (bridge capacity) = (combined weight of truck and driver) + (total weight of loaded boxes)
        5. 5000 pounds = 3755 pounds + (15 pounds/box) * number_of_boxes
        6. Subtract the combined weight of the truck and driver from both sides to isolate the term with the box weight
        7. 8. 5000 - 3755 = 1245 pounds = (15 pounds/box) * number_of_boxes
        9. To find the unknown variable, divide by 15
        number_of_boxes = 1245 / 15
        10. Now calculate the result
        number_of_boxes =",Node18,3,5,5,10,0.9040939700073324,83,False
" 1. First, let's identify the important variables we need to work with. We have the bridge's capacity (5000 pounds), the combined weight of the driver and truck (3755 pounds), and the box's individual weight (15 pounds).
        2. Next, we want to determine how many boxes can be loaded before exceeding the bridge's capacity. We know that the current load on the bridge comes from the truck + driver + boxes.
        3. Now, let's set up an equation 4. Total weight (bridge capacity) = (combined weight of truck and driver) + (total weight of loaded boxes)
        5. 5000 pounds = 3755 pounds + (15 pounds/box) * number_of_boxes
        6. Subtract the combined weight of the truck and driver from both sides to isolate the term with the box weight
        7. 8. 4245 pounds = (15 pounds/box) * number_of_boxes
        9. To find the number of boxes, we need to divide the remaining weight by the individual box weight
        10. Number_of_boxes = 4245 pounds / 15 pounds/box
        11. Number_of_boxes = 283
        12. Therefore, the maximum number of boxes which can be loaded onto the truck while not exceeding the bridge's weight limit is 2",Node19,1,2,3,5,0.3435857966363247,116,False
" 1. We need to find out how much the truck will weigh with the maximum possible load of boxes.
2. The driver and the empty truck weigh a total of 3755 pounds.
3. Each box weighs 15 pounds, and we want to know the maximum number that can be loaded without exceeding the weight limit.
4. The bridge's capacity is 5000 pounds, so we need to deduct the weight of the driver and truck from this amount to find out how much load is left for boxes.
5. Available load for the boxes = Bridge Capacity - Weight of Driver + Truck Empty Weight = 5000 - 3755 + 0 = 1245 pounds.",Node28,3,1,5,6,0.7900835182867443,105,False
" 1. We need to find out how much the truck will weigh with the maximum possible load of boxes.
2. The driver and the empty truck weigh a total of 3755 pounds.
3. Each box weighs 15 pounds, and we want to know the maximum number of boxes that can be loaded while not exceeding the bridge's limit.
4. A full truck would have all the 5000-pound limit from the bridge used for carrying the weight of the boxes only. The driver and the empty truck still need their share of the weight limit.
5. If we subtract the combined weight of the driver and the empty truck (",Node29,3,2,5,7,0.6735418352485135,86,False
" 1. We need to find out how much the truck will weigh with the maximum possible load of boxes.
2. The driver and the empty truck weigh a total of 3755 pounds.
3. Each box weighs 15 pounds, and we want 3.a. To calculate the weight of all the boxes: Number of boxes * Weight per box = (Total boxes) * 15
4. We need to find out how many boxes can be loaded while still being under the bridge's weight limit of 5000 pounds.
5. The current combined weight of driver, truck, and boxes is 375",Node30,8,9,10,19,0.4594549884503566,80,False
" 1. We need to find out how much the truck will weigh with the maximum possible load of boxes.
2. The driver and the empty truck weigh a total of 3755 pounds.
3. Each box weighs 15 pounds, and we want to know how many boxes can be put on the truck without exceeding the bridge's weight limit (5000 pounds).
4. We need to add the weight of the boxes to the driver and empty truck's combined weight to get the total weight with maximum loaded boxes.
5.",Node31,1,4,3,7,0.9301691190372535,62,False
" 1. We need to find out how much the truck will weigh with the maximum possible load of boxes.
2. The driver and the empty truck weigh a total of 3755 pounds.
3. Each box weighs 15 pounds, and we want to fill it as much as possible without exceeding the bridge's limit.
4. We know that the bridge can carry no more than 5000 pounds.
5. To find out how many boxes we can load, we need to subtract the weight of the driver and empty truck from the bridge's limit: 5000 - 3755 = 1245 pounds remaining for the boxes.
6. Now,",Node33,1,2,3,5,0.26779820467983373,97,False
" 1. We need to find out how much the truck will weigh with the maximum possible load of boxes.
2. The driver and the empty truck weigh a total of 3755 pounds.
3. Each box weighs 15 pounds, and we want to maximize the number of boxes on the truck without exceeding the bridge's weight limit.
4. The bridge can carry up to 5000 pounds.
5. To find out how much the truck will weigh with all boxes loaded, add the driver and empty truck weight (3755 pounds) to the combined weight of all boxes: 
         (3755 pounds + (number of boxes * 15 pounds)) <= 5000 pounds
6. Let's assume a variable 'x'",Node34,2,1,4,5,0.38911031338281366,114,False
" 1. We need to find out how much the truck will weigh with the maximum possible load of boxes.
2. The driver and the empty truck weigh a total of 3755 pounds.
3. Each box weighs 15 pounds, and we want to fill it as much as possible without exceeding the bridge's limit.
4. We know that the bridge can carry no more than 5000 pounds.
5. To find out how many boxes we can load, we need to subtract the weight of the driver and empty truck from the bridge's limit: 5000 - 3755 = 1245 pounds remaining for the boxes.
6. Now, a. We know that each box weighs 15 pounds.
         b. To find out how many boxes can be loaded without exceeding the bridge's limit, we need to divide the remaining weight by the weight of one box",Node36,1,1,4,5,0.313735711407091,49,0
" 1. We need to find out how much the truck will weigh with the maximum possible load of boxes.
2. The driver and the empty truck weigh a total of 3755 pounds.
3. Each box weighs 15 pounds, and we want to fill it as much as possible without exceeding the bridge's limit.
4. We know that the bridge can carry no more than 5000 pounds.
5. To find out how many boxes we can load, we need to subtract the weight of the driver and empty truck from the bridge's limit: 5000 - 3755 = 1245 pounds remaining for the boxes.
6. Now, - We know each box weighs 15 pounds, so to find out how many boxes we can load before reaching the weight limit, we need to divide the remaining weight by the weight of a single box",Node37,1,1,4,5,0.5158695455653952,42,0
" 1. We need to find out how much the truck will weigh with the maximum possible load of boxes.
2. The driver and the empty truck weigh a total of 3755 pounds.
3. Each box weighs 15 pounds, and we want to fill it as much as possible without exceeding the bridge's limit.
4. We know that the bridge can carry no more than 5000 pounds.
5. To find out how many boxes we can load, we need to subtract the weight of the driver and empty truck from the bridge's limit: 5000 - 3755 = 1245 pounds remaining for the boxes.
6. Now, we know the box weighs 15 pounds each and the question is about how many boxes can be loaded without exceeding the weight limit on the bridge. Therefore, we need to divide the remaining weight by the weight of one box: 1245 / 15 = 83 boxes.
7. So, we can load a maximum of 83 boxes",Node38,0,0,3,3,0.8136417850571799,78,0
