continuation,Node Path,V Score,H Score,G Score,F Score,Temperature,Max Tokens,Wrong Solution Flag
" 1. First, let's find out the total calories in the 300g bag of chips by multiplying the number of servings (5) by the calories per serving (250).
            Total",Node0,1,8,1,9,0.3206665331756897,46,False
" 1. We need to determine the calories from the entire 300g bag before dividing it into servings. To do this, multiply 250 calories per serving by 5 servings in one 300g bag.
            Total calories for the whole 300g bag = 250 calories/serving * 5 servings = 1",Node1,2,8,2,10,0.8905989808023136,82,False
" 1. First, let's find out the total number of calories in a 300g bag of chips. We know there are 5 servings with 250 calories each, so we multiply the serving size by the number of servings: 250 * 5 = 1250 calories per 300g bag.
        2. Now, let's determine how many grams you can eat from this bag to reach your daily calorie target of 2000. You have already consumed 1800",Node2,1,4,1,5,0.07678467146310164,120,False
" 1. First, let's find the total number of calories in a 300g bag of chips by multiplying the calories per serving (250) by the number of servings (5).
            Total calories = 250 * 5 = 1250 calories
        2",Node3,1,4,1,5,0.49721246453299117,66,False
" 1. Firstly, let's figure out the total number of calories in a 300g bag of chips by multiplying the servings size per bag (which we know to be 250 calories) with the number of servings available in the bag (5). So, 250 * 5 = 1250 calories.
        2. You've already consumed 1800 calories and your daily target",Node4,1,4,1,5,0.783997866713156,95,False
" 1. First, let's determine the total calories in the whole bag of chips. To do this, we multiply the number of servings by the calories per serving. So, 5 servings * 250 calories/serving = 1250 calories.
        2. Now",Node5,1,4,1,5,0.3612415572397597,64,False
" 1. First, let's find out the total number of calories in a 300g bag of chips. We know there are 5 servings with 250 calories each, so we multiply the serving size by the number of servings: 250 * 5 = 1250 calories per 300g bag.
        2. Now, let's determine how many grams you can eat from this bag to reach your daily calorie target of 2000. You have already consumed 1800 calories and want to consume an additional 200 calories to reach the target. So we subtract the consumed calories from the desired daily intake: 2000 - 1800 = 200 calories remaining.
        3. Next, let's find out how many grams you can eat to get those remaining 200 calories. We know there are 1250 calories in a 3",Node7,2,3,3,6,0.6744595159048179,92,False
" 1. First, let's find out the total number of calories in a 300g bag of chips. We know there are 5 servings with 250 calories each, so we multiply the serving size by the number of servings: 250 * 5 = 1250 calories per 300g bag.
        2. Now, let's determine how many grams you can eat from this bag to reach your daily calorie target of 2000. You have already consumed 1800 calories and need an additional 200 calories for the whole day (2000 - 1800 = 200 calories).
        3. We know there are 1250 calories in a 300g bag, so we divide your calorie goal of 200 by this number to find out how many grams you can eat: 200 /",Node8,2,3,3,6,0.8468717752976652,87,False
" 1. First, let's find out the total number of calories in a 300g bag of chips. We know there are 5 servings with 250 calories each, so we multiply the serving size by the number of servings: 250 * 5 = 1250 calories per 300g bag.
        2. Now, let's determine how many grams you can eat from this bag to reach your daily calorie target of 2000. You have already consumed 1800 calories, so we need to subtract that from the total daily goal: 2000 - 1800 = 200 calories remaining for the day.
        3.",Node10,2,7,3,10,0.4374447273859309,41,False
" 1. First, let's find out the total number of calories in a 300g bag of chips. We know there are 5 servings with 250 calories each, so we multiply the serving size by the number of servings: 250 * 5 = 1250 calories per 300g bag.
        2. Now, let's determine how many grams you can eat from this bag to reach your daily calorie target of 2000. You have already consumed 1800 calories and have 2000 - 1800 = 200 calories left to consume before reaching your daily calorie goal. We know that there are 250 calories per serving and the total calories in a 300g bag are 1250. To calculate how many servings give you those extra 200 calories, divide the target number of calories (200) by the calories per serving (250): 200 /",Node11,2,3,3,6,0.9556799820235339,105,False
" 1. First, let's find out the total number of calories in a 300g bag of chips. We know there are 5 servings with 250 calories each, so we multiply the serving size by the number of servings: 250 * 5 = 1250 calories per 300g bag.
        2. Now, let's determine how many grams you can eat from this bag to reach your daily calorie target of 2000. You have already consumed 1800 calories. To reach the desired intake, subtract the total number of calories you have consumed so far: 2000 - 1800 = 200 calories left to consume for the day.
        3. Calculate how much of the 1250",Node12,2,3,3,6,0.8505845330846825,61,False
" 1. First, let's find the total number of calories in a 300g bag of chips by multiplying the calories per serving (250) by the number of servings (5).
            Total calories = 250 * 5 = 1250 calories
        2 2. Next, calculate your calorie budget for the rest of the day, which is the difference between your daily target (2000 calories) and what you have already consumed (1800 calories).
            Remaining daily calorie budget = Daily target - Cons",Node15,1,8,2,10,0.9256780144771981,57,False
" 1. First, let's find the total number of calories in a 300g bag of chips by multiplying the calories per serving (250) by the number of servings (5).
            Total calories = 250 * 5 = 1250 calories
        2 2. Now, we need to find out how many grams you can eat from the bag based on your daily calorie target and the remaining calories you have. Your daily calorie target is 2000, and after consuming 1800 calories, you have 200 remaining calories.
            Remaining calories = Daily target - Consumed calories =",Node17,1,8,2,10,0.5386285861145127,78,False
" 1. Firstly, let's figure out the total number of calories in a 300g bag of chips by multiplying the servings size per bag (which we know to be 250 calories) with the number of servings available in the bag (5). So, 250 * 5 = 1250 calories.
        2. You've already consumed 1800 calories and your daily target is 2000 calories. To find out how many more calories you can consume before reaching your daily limit of 2000, subtract the calories consumed from your daily target: 2000 - 1800 = 200 calories remaining for the day.
        3. Now, we need to determine how many grams of chips you can eat without exceeding your remaining calorie limit of 200 calories. We know that each gram of chips has a fixed number of calories (which is",Node21,2,3,3,6,0.8432878304870417,113,False
" 1. Firstly, let's figure out the total number of calories in a 300g bag of chips by multiplying the servings size per bag (which we know to be 250 calories) with the number of servings available in the bag (5). So, 250 * 5 = 1250 calories.
        2. You've already consumed 1800 calories and your daily target is 2000 calories. To find out how many more calories you can consume to reach your daily goal, subtract the calories you've already had from your daily target: 2000 - 1800 = 200 calories remaining.
        3. Now, we need to",Node22,2,3,3,6,0.0876361646334981,66,False
" 1. Firstly, let's figure out the total number of calories in a 300g bag of chips by multiplying the servings size per bag (which we know to be 250 calories) with the number of servings available in the bag (5). So, 250 * 5 = 1250 calories.
        2. You've already consumed 1800 calories and your daily target is 2000 calories. To calculate how many more you can consume without exceeding your daily intake, subtract the total calories you have consumed from your total calorie goal: 2000 - 1800 = 200 remaining calories.
        3. Now, we know there are 1250 calories",Node23,2,3,3,6,0.8379851215991402,74,False
" 1. Firstly, let's figure out the total number of calories in a 300g bag of chips by multiplying the servings size per bag (which we know to be 250 calories) with the number of servings available in the bag (5). So, 250 * 5 = 1250 calories.
        2. You've already consumed 1800 calories and your daily target is 2000 calories. To find out how many more calories you can consume, subtract the calories you've already had from your daily target: 2000 - 1800 = 200 calories remaining for today.
        3. Now we need to determine how many grams of chips you can eat while staying within your cal",Node24,2,3,3,6,0.06249515162823205,77,False
" 1. Firstly, let's figure out the total number of calories in a 300g bag of chips by multiplying the servings size per bag (which we know to be 250 calories) with the number of servings available in the bag (5). So, 250 * 5 = 1250 calories.
        2. You've already consumed 1800 calories and your daily target is 2000 calories, so you have 2000 - 1800 = 200 calories left to consume in the day.
        3. Now let's find out how much you can eat from this bag of chips using the remaining 200 calories available. To do that, divide the total number of calories in one serving (250) by the remaining calories you",Node25,1,3,2,5,0.7451818217627331,88,False
" 1. Firstly, let's figure out the total number of calories in a 300g bag of chips by multiplying the servings size per bag (which we know to be 250 calories) with the number of servings available in the bag (5). So, 250 * 5 = 1250 calories.
        2. You've already consumed 1800 calories and your daily target is set at 2000 calories. To find out how many more calories you can consume before reaching the daily limit, subtract the current calories from your target: 2000 - 1800 = 200 calories.
        3. Now we know that you're allowed an additional 200 calories for today and have a 300g bag of chips with 1250 calories per serving. To determine how many servings",Node26,2,3,3,6,0.7738061651939255,101,False
" 1. Firstly, let's figure out the total number of calories in a 300g bag of chips by multiplying the servings size per bag (which we know to be 250 calories) with the number of servings available in the bag (5). So, 250 * 5 = 1250 calories.
        2. You've already consumed 1800 calories and your daily target is 2000 calories. To find out how many more calories you can consume, subtract the calories you've already had from the target: 2000 - 1800 = 200 calories remaining for today.
        3. Now we need to determine how many grams of chips",Node27,2,3,3,6,0.4186678803739865,68,False
" 1. First, let's determine the total calories in the whole bag of chips. To do this, we multiply the number of servings by the calories per serving. So, 5 servings * 250 calories/serving = 1250 calories.
        2. Now 3. Next, let's find out how many grams are in one serving. To do this, we divide the total weight of the bag by the number of servings. So, 300g / 5 servings = 60g per serving.
        4. Since you have already consumed 1800 calories and your daily target",Node28,2,8,3,11,0.41222571307764255,76,False
" 1. First, let's determine the total calories in the whole bag of chips. To do this, we multiply the number of servings by the calories per serving. So, 5 servings * 250 calories/serving = 1250 calories.
        2. Now 3. Next, let's find out how many grams are in a single serving. To do this, we divide the total weight of the bag by the number of servings. So, 300g / 5 servings = 60g per serving.
        4. Now that we know the calories and grams per serving, let's calculate how many calories are left for you to consume in your daily target of 2000",Node29,2,8,3,11,0.11867485973615133,97,False
" 1. First, let's determine the total calories in the whole bag of chips. To do this, we multiply the number of servings by the calories per serving. So, 5 servings * 250 calories/serving = 1250 calories.
        2. Now 3. We know that you have a daily calorie target of 2000 and you have consumed 1800 calories so far. To find out how many more calories are left, subtract the consumed calories from your target: 2000 - 1800 = 200 remaining calories.
        4. Next, we need to convert the remaining calories into grams of chips to eat. Since there are 125",Node30,1,7,2,9,0.8250285126164366,97,False
" 1. First, let's determine the total calories in the whole bag of chips. To do this, we multiply the number of servings by the calories per serving. So, 5 servings * 250 calories/serving = 1250 calories.
        2. Now 3. you know that you need to consume another 200 calories (your daily target is 2000, and you've already consumed 1800) before reaching your goal for the day.
        4. Next, let's find out how many of these remaining 200 calories can be provided by eating the chips. To do this, we'll",Node31,2,8,3,11,0.981145502062662,82,False
" 1. First, let's determine the total calories in the whole bag of chips. To do this, we multiply the number of servings by the calories per serving. So, 5 servings * 250 calories/serving = 1250 calories.
        2. Now 3. We need to find out how many grams you can eat from the bag of chips while staying within your daily calorie target. Your remaining calorie intake is 2000 - 1800 = 200 calories.
        4. Divide the remaining calories by the total calories in the whole",Node32,1,6,2,8,0.38167287052366683,69,False
" 1. First, let's determine the total calories in the whole bag of chips. To do this, we multiply the number of servings by the calories per serving. So, 5 servings * 250 calories/serving = 1250 calories.
        2. Now 3. Next, we need to find out how many grams you can eat from the bag without going over your daily calorie target of 2000. To do this, subtract the calories you've already consumed (1800) from your daily calorie target (20",Node33,2,8,3,11,0.36371834928290525,62,False
" 1. First, let's find out the total number of calories in a 300g bag of chips. We know there are 5 servings with 250 calories each, so we multiply the serving size by the number of servings: 250 * 5 = 1250 calories per 300g bag.
        2. Now, let's determine how many grams you can eat from this bag to reach your daily calorie target of 2000. You have already consumed 1800 calories and want to consume an additional 200 calories to reach the target. So we subtract the consumed calories from the desired daily intake: 2000 - 1800 = 200 calories remaining.
        3. Next, let's find out how many grams you can eat to get those remaining 200 calories. We know there are 1250 calories in a 3 4. Finally, divide the remaining calories by the number of calories per gram: 200 / 1250 = 0.16. This means that you can eat approximately 0.16 * 300g (since there are 300 grams in a bag) or around 48 grams of chips from this bag to reach your daily calorie target while staying within the recommended",Node43,2,1,5,6,0.2769745143825997,89,False
" 1. First, let's find out the total number of calories in a 300g bag of chips. We know there are 5 servings with 250 calories each, so we multiply the serving size by the number of servings: 250 * 5 = 1250 calories per 300g bag.
        2. Now, let's determine how many grams you can eat from this bag to reach your daily calorie target of 2000. You have already consumed 1800 calories and want to consume an additional 200 calories to reach the target. So we subtract the consumed calories from the desired daily intake: 2000 - 1800 = 200 calories remaining.
        3. Next, let's find out how many grams you can eat to get those remaining 200 calories. We know there are 1250 calories in a 3 4. Lastly, we need to divide the remaining calorie amount by the calories per gram of chips (1250) and then multiply that result by the serving size (250): (200",Node48,3,2,6,8,0.693721569691925,46,False
" 1. First, let's find out the total number of calories in a 300g bag of chips. We know there are 5 servings with 250 calories each, so we multiply the serving size by the number of servings: 250 * 5 = 1250 calories per 300g bag.
        2. Now, let's determine how many grams you can eat from this bag to reach your daily calorie target of 2000. You have already consumed 1800 calories and need an additional 200 calories for the whole day (2000 - 1800 = 200 calories).
        3. We know there are 1250 calories in a 300g bag, so we divide your calorie goal of 200 by this number to find out how many grams you can eat: 200 / 1250 = 0.16 grams per calorie from the bag (approximately).
        4. To convert this back into grams, multiply it by 300g, which is the weight of a single bag: 0.16 * 300 = 48 grams. You can eat up to 48 grams from the 300g bag of chips without going over your daily calorie target.",Node49,1,1,4,5,0.6519630076221308,116,False
" 1. First, let's find out the total number of calories in a 300g bag of chips. We know there are 5 servings with 250 calories each, so we multiply the serving size by the number of servings: 250 * 5 = 1250 calories per 300g bag.
        2. Now, let's determine how many grams you can eat from this bag to reach your daily calorie target of 2000. You have already consumed 1800 calories and need an additional 200 calories for the whole day (2000 - 1800 = 200 calories).
        3. We know there are 1250 calories in a 300g bag, so we divide your calorie goal of 200 by this number to find out how many grams you can eat: 200 / 1250 = 0.16 g per calorie.
        4. Finally, multiply this fraction by the weight of a single serving (300g) to determine the amount you can safely consume: 0.16 * 300g = 48 g.

You can eat up to 48 grams from the bag while keeping within your daily calorie target, given your current consumption and the nutritional information about the chips.",Node50,1,1,4,5,0.971217331669159,108,False
" 1. First, let's find out the total number of calories in a 300g bag of chips. We know there are 5 servings with 250 calories each, so we multiply the serving size by the number of servings: 250 * 5 = 1250 calories per 300g bag.
        2. Now, let's determine how many grams you can eat from this bag to reach your daily calorie target of 2000. You have already consumed 1800 calories and need an additional 200 calories for the whole day (2000 - 1800 = 200 calories).
        3. We know there are 1250 calories in a 300g bag, so we divide your calorie goal of 200 by this number to find out how many grams you can eat: 200 / 1250 = 0.16. This means you can eat approximately 16% (rounded to two decimal places) of the whole bag or 48 grams (0.16 * 3",Node55,1,1,4,5,0.736509848775575,47,False
" 1. First, let's find out the total number of calories in a 300g bag of chips. We know there are 5 servings with 250 calories each, so we multiply the serving size by the number of servings: 250 * 5 = 1250 calories per 300g bag.
        2. Now, let's determine how many grams you can eat from this bag to reach your daily calorie target of 2000. You have already consumed 1800 calories and need an additional 200 calories for the whole day (2000 - 1800 = 200 calories).
        3. We know there are 1250 calories in a 300g bag, so we divide your calorie goal of 200 by this number to find out how many grams you can eat: 200 / 1250 = 0.16. This means you can eat approximately 16% (rounded to two decimal places) of the whole bag or 48 grams (0.16 * 3 00g).",Node70,2,0,6,6,0.09152320102928224,69,False
