continuation,Node Path,V Score,H Score,G Score,F Score,Temperature,Max Tokens,Wrong Solution Flag
" 1. First, let's calculate the total amount of dog food needed for the first 180 days. We know that she feeds the puppy 1 cup per day. So, we multiply the number of days (180) by the daily amount (1 cup). This gives us 180 * 1 = 180 cups of dog food needed for the first 1",Node1,2,7,2,9,0.22637261802905195,86,False
" 1. First, we need to know how long a year is in terms of days. There are around 365 days in a year (or 365.25 if you count leap years).
        2. Now, we will find out the total dog food Cecilia needs for the first 180 days. She feeds",Node2,4,9,4,13,0.9031067401609876,73,False
" 1. First, let's calculate the total amount of dog food needed for the first 180 days. We know that she feeds the puppy 1 cup per day and this lasts for 180 days. So, we multiply these two numbers together: 1 cup/day *",Node3,3,7,3,10,0.05567608736702667,66,False
" 1. First, let's calculate the total amount of dog food needed during the first 180 days (the puppy's growth period).
           For this period, Cecilia feeds her puppy 1 cup per day for 180 days. So, we multiply these two numbers: 1 cup/day * 180 days = 180 cups of dog food.
        2. Next, calculate the total amount of dog food needed from day 181 to the end of the first year (the puppy",Node4,3,5,3,8,0.3281603155904693,118,False
" 1. First, let's calculate the total amount of dog food needed for the first 180 days. We know that she feeds the puppy 1 cup per day for this period. So, we multiply the number of days (180) by the daily amount (1 cup).
            Total",Node5,3,7,3,10,0.05292278333082212,67,False
" 1. Find out how much dog food is needed for the first 180 days (365 days in a year) - 180 days
        1 Cup/Day * 180 Days = 180 Cups of Dog Food used during this period",Node6,2,7,2,9,0.7970039424494967,59,False
" 1. First, let's calculate the total amount of dog food needed during the first 180 days (the puppy's growth period).
           For this period, Cecilia feeds her puppy 1 cup per day for 180 days. So, we multiply these two numbers: 1 cup/day * 180 days = 180 cups of dog food.
        2. Next, calculate the total amount of dog food needed from day 181 to the end of the first year (the puppy will be fed with 2 cups per day). We'll multiply the number of days left in the year by the daily amount: (365 - 180) days * 2 cups/day = 185 days * 2 cups/day = 370 cups of dog food.
        3. Now, we need to find out how many bags of dog food are needed for each period. For the growth period, Cecilia needs 1 bag (",Node7,2,5,5,10,0.49536142992055054,102,False
" 1. First, let's calculate the total amount of dog food needed during the first 180 days (the puppy's growth period).
           For this period, Cecilia feeds her puppy 1 cup per day for 180 days. So, we multiply these two numbers: 1 cup/day * 180 days = 180 cups of dog food.
        2. Next, calculate the total amount of dog food needed from day 181 to the end of the first year (the puppy becomes an adult). Cecilia will feed her puppy 2 cups per day for 365 days (one year) minus the growth period (180 days), which is 365 - 180 = 185 days. So, she needs to feed the puppy 2 cups/day * 185 days = 370 cups of dog food for this period.
        3. Now, we need to add up all the cups of dog food needed during both periods. We have 180",Node11,1,2,4,6,0.42004188402519393,116,False
" 1. First, let's calculate the total amount of dog food needed during the first 180 days (the puppy's growth period).
           For this period, Cecilia feeds her puppy 1 cup per day for 180 days. So, we multiply these two numbers: 1 cup/day * 180 days = 180 cups of dog food.
        2. Next, calculate the total amount of dog food needed from day 181 to the end of the first year (the puppy is considered an adult).
           For this period, Cecilia feeds her puppy 2 cups per day for 365 days - 180 days (since we already accounted for the growth period). So, we multiply these two numbers: 2 cups/day *",Node13,1,2,4,6,0.17207252825728658,61,False
" 1. First, let's calculate the total amount of dog food needed during the first 180 days (the puppy's growth period).
           For this period, Cecilia feeds her puppy 1 cup per day for 180 days. So, we multiply these two numbers: 1 cup/day * 180 days = 180 cups of dog food.
        2. Next, calculate the total amount of dog food needed from day 181 to the end of the first year (the puppy becomes an adult). Cecilia will feed her puppy 2 cups per day for 365 days (one year) minus the growth period (180 days), which is 365 - 180 = 185 days. So, she needs to feed the puppy 2 cups/day * 185 days = 370 cups of dog food for this period.
        3. Now, we need to add up all the cups of dog food needed during both periods. We have 180 cups from the growth period and 370 cups from the adult phase. So, 180 + 370 = 550 cups in total for the first year.",Node14,1,1,5,6,0.6213166239933129,42,False
" 1. First, let's calculate the total amount of dog food needed during the first 180 days (the puppy's growth period).
           For this period, Cecilia feeds her puppy 1 cup per day for 180 days. So, we multiply these two numbers: 1 cup/day * 180 days = 180 cups of dog food.
        2. Next, calculate the total amount of dog food needed from day 181 to the end of the first year (the puppy becomes an adult). Cecilia will feed her puppy 2 cups per day for 365 days (one year) minus the growth period (180 days), which is 365 - 180 = 185 days. So, she needs to feed the puppy 2 cups/day * 185 days = 370 cups of dog food for this period.
        3. Now, we need to add up all the cups of dog food needed during both periods. We have 180 cups from the growth period and 370 cups from the adult stage. So, 180 + 370 = 550 cups in total.
        4. Finally, we need to divide the total amount of dog food needed (550 cups) by the number of cups per bag (110 cups/bag). This will give us the number of bags Cecilia needs for the first year: 550 cups / 110 cups/bag =",Node17,1,2,5,7,0.4075128469298308,104,False
" 1. First, let's calculate the total amount of dog food needed during the first 180 days (the puppy's growth period).
           For this period, Cecilia feeds her puppy 1 cup per day for 180 days. So, we multiply these two numbers: 1 cup/day * 180 days = 180 cups of dog food.
        2. Next, calculate the total amount of dog food needed from day 181 to the end of the first year (the puppy becomes an adult). Cecilia will feed her puppy 2 cups per day for 365 days (one year) minus the growth period (180 days), which is 365 - 180 = 185 days. So, she needs to feed the puppy 2 cups/day * 185 days = 370 cups of dog food for this period.
        3. Now, we need to add up all the cups of dog food needed during both periods. We have 180 cups (growth period) + 370 cups (adult stage) = 550 cups of dog food in total.
        4. Finally, divide the total amount of dog food by the number of cups per bag (110 cups/bag",Node18,1,2,5,7,0.5380703820453705,56,False
" 1. First, let's calculate the total amount of dog food needed during the first 180 days (the puppy's growth period).
           For this period, Cecilia feeds her puppy 1 cup per day for 180 days. So, we multiply these two numbers: 1 cup/day * 180 days = 180 cups of dog food.
        2. Next, calculate the total amount of dog food needed from day 181 to the end of the first year (the puppy becomes an adult). Cecilia will feed her puppy 2 cups per day for 365 days (one year) minus the growth period (180 days), which is 365 - 180 = 185 days. So, she needs to feed the puppy 2 cups/day * 185 days = 370 cups of dog food for this period.
        3. Now, we need to add up all the cups of dog food needed during both periods. We have 180 cups from the growth period and 370 cups from the adult stage. So, 180 + 370 = 550 cups in total.
        4. Finally, we know that one bag of dog food contains 110 cups. To find out how many bags Cecilia will need to buy for",Node20,1,1,5,6,0.4338721902987962,70,False
" 1. First, let's calculate the total amount of dog food needed during the first 180 days (the puppy's growth period).
           For this period, Cecilia feeds her puppy 1 cup per day for 180 days. So, we multiply these two numbers: 1 cup/day * 180 days = 180 cups of dog food.
        2. Next, calculate the total amount of dog food needed from day 181 to the end of the first year (the puppy is considered an adult).
           For this period, Cecilia feeds her puppy 2 cups per day for 365 days - 180 days (since we already accounted for the growth period). So, we multiply these two numbers: 2 cups/day * (365 - 180) days = 485 cups of dog food.
        3. Now, let's add up the total amount of dog food needed for both periods to find out how much dog food Cecilia will need in the first year.
           Total dog food needed =",Node21,5,10,9,19,0.4385242840517056,66,False
" 1. First, let's calculate the total amount of dog food needed during the first 180 days (the puppy's growth period).
           For this period, Cecilia feeds her puppy 1 cup per day for 180 days. So, we multiply these two numbers: 1 cup/day * 180 days = 180 cups of dog food.
        2. Next, calculate the total amount of dog food needed from day 181 to the end of the first year (the puppy is considered an adult).
           For this period, Cecilia feeds her puppy 2 cups per day for 365 days - 180 days (since we already accounted for the growth period). So, we multiply these two numbers: 2 cups/day * (365 - 180) days = 605 cups of dog food.
        3. Now, let's add up the total amount of dog food needed in both periods.
           We add the dog food for the growth period and the adult period: 180 cups + 605 cups = 78",Node22,2,5,6,11,0.5232161539660881,74,False
" 1. First, let's calculate the total amount of dog food needed during the first 180 days (the puppy's growth period).
           For this period, Cecilia feeds her puppy 1 cup per day for 180 days. So, we multiply these two numbers: 1 cup/day * 180 days = 180 cups of dog food.
        2. Next, calculate the total amount of dog food needed from day 181 to the end of the first year (the puppy is considered an adult).
           For this period, Cecilia feeds her puppy 2 cups per day for 365 days - 180 days (since we already accounted for the growth period). So, we multiply these two numbers: 2 cups/day * (365 days - 180 days) = 2 cups/day * 185 days = 370 cups of dog food.
        3. Now, add up the total amount of dog",Node24,0,1,4,5,0.8782600345937276,47,False
" 1. First, let's calculate the total amount of dog food needed during the first 180 days (the puppy's growth period).
           For this period, Cecilia feeds her puppy 1 cup per day for 180 days. So, we multiply these two numbers: 1 cup/day * 180 days = 180 cups of dog food.
        2. Next, calculate the total amount of dog food needed from day 181 to the end of the first year (the puppy is considered an adult).
           For this period, Cecilia feeds her puppy 2 cups per day for 365 days - 180 days (since we already accounted for the growth period). So, we multiply these two numbers: 2 cups/day * (365 - 180) days = 780 cups of dog food.
        Now, let's find the total amount of dog food needed in one year.
        We add the dog food needed during the growth period and the adult period: 180 cups + 780 cups = 960 cups of dog food.
        4. Finally,",Node25,1,3,5,8,0.4669619220916602,84,False
" 1. First, let's calculate the total amount of dog food needed during the first 180 days (the puppy's growth period).
           For this period, Cecilia feeds her puppy 1 cup per day for 180 days. So, we multiply these two numbers: 1 cup/day * 180 days = 180 cups of dog food.
        2. Next, calculate the total amount of dog food needed from day 181 to the end of the first year (the puppy is considered an adult).
           For this period, Cecilia feeds her puppy 2 cups per day for 365 days - 180 days (since we already accounted for the growth period). So, we multiply these two numbers: 2 cups/day * (365 - 180) days = 780 cups of dog food.
        3. Now, let's add up the total amount of dog food needed during both periods to find out how much Cecilia will use in the first year.
           Total dog food needed = 180 cups (growth period) + 780 cups (adult",Node26,1,0,5,5,0.11576043607348618,82,False
