continuation,Node Path,V Score,H Score,G Score,F Score,Temperature,Max Tokens,Wrong Solution Flag
" 1. Let's first determine the potential profit for each option based on their respective price increases.
           a. For jewelry worth $5,000: 2.5% increase = (2.5/1",Node0,5,8,5,13,0.7298042759274226,47,False
" 1. First, let's consider the current value and projected increase in value for both options.
           - Jewelry worth $5,000 will have an increased value of $5,000 * 2.5% = $125. So, after the price rise, it would be worth $5,",Node1,2,5,2,7,0.4771979484052522,71,False
" 1. First, we need to determine the initial value of each item and their respective price increases.
           - Jewelry is worth $5,000, and its market will increase by 2.5%. So, after the increase, it'll be worth ($5,000 * 1.025) = $5,12",Node2,2,5,2,7,0.6064698705056188,77,False
" 1. First, we need to determine the initial value of both purchase options. The jewelry costs $5,000 and the electronic gadgets cost $8,000.
        2. Next, calculate the projected increase in value for each item based on their respective market growth rates. For jewelry, the 2.5% increase will be $5,000 * 0.025 = $125. So, the new value of jewelry would be $5,000 + $125 = $5,125",Node3,1,3,1,4,0.25967608672963083,120,False
" 1. Analyze the given choices and their respective prices and expected market growth rates.
           - Option A: Jewelry worth $5,000, market expected to rise by 2.5%
           - Option B",Node4,7,9,7,16,0.9721607387396762,50,False
" 1. First, let's consider the merchant's options and their potential profits without any market change. The jewelry costs $5,000 and has a potential profit margin. Electronic gadgets cost $8,000 and also have a certain profit margin. If these markets stay",Node5,4,9,4,13,0.9734262425584355,62,False
" 1. Let's first understand the given information:
           - Merchant can choose between jewelry worth $5,000 or electronic gadgets worth $8,000.
           - Financial advisor predicts jewelry market will increase by 2.5% and electronic gadgets market will rise by 1.2%.
           - The merchant wants",Node6,3,9,3,12,0.4567145347417313,78,False
" 1. First, we need to determine the initial value of both purchase options. The jewelry costs $5,000 and the electronic gadgets cost $8,000.
        2. Next, calculate the projected increase in value for each item based on their respective market growth rates. For jewelry, the 2.5% increase will be $5,000 * 0.025 = $125. So, the new value of jewelry would be $5,000 + $125 = $5,125 3. Similarly, for electronic gadgets, a 1.2% increase will result in an additional value of $8,000 * 0.012 = $96. The new value of the gadgets would be $8,000 + $96 = $8,096
        4. Now that we have the projected values for both items after their respective market growth rates, we can compare them to determine which option will provide a higher profit.
        5. The difference in",Node7,4,3,5,8,0.11791507515752264,111,False
" 1. First, we need to determine the initial value of both purchase options. The jewelry costs $5,000 and the electronic gadgets cost $8,000.
        2. Next, calculate the projected increase in value for each item based on their respective market growth rates. For jewelry, the 2.5% increase will be $5,000 * 0.025 = $125. So, the new value of jewelry would be $5,000 + $125 = $5,125 3. Similarly, for electronic gadgets, the 1.2% increase will be $8,000 * 0.012 = $96. So, the new value of electronic gadgets would be $8,000 + $96 = $8,096
        4. Now that we have the projected values for both items after their respective market growth",Node8,4,3,5,8,0.23394143265226697,85,False
" 1. First, we need to determine the initial value of both purchase options. The jewelry costs $5,000 and the electronic gadgets cost $8,000.
        2. Next, calculate the projected increase in value for each item based on their respective market growth rates. For jewelry, the 2.5% increase will be $5,000 * 0.025 = $125. So, the new value of jewelry would be $5,000 + $125 = $5,125 3. Similarly, for electronic gadgets, a 1.2% increase will amount to $8,000 * 0.012 = $96. So, the new value of electronic gadgets would be $8,000 + $96 = $8,096
        4. Now that we have the projected values for both items after market growth, we can compare them to determine which",Node9,4,3,5,8,0.21781256501756197,92,False
" 1. First, we need to determine the initial value of both purchase options. The jewelry costs $5,000 and the electronic gadgets cost $8,000.
        2. Next, calculate the projected increase in value for each item based on their respective market growth rates. For jewelry, the 2.5% increase will be $5,000 * 0.025 = $125. So, the new value of jewelry would be $5,000 + $125 = $5,125 3. Similarly, for electronic gadgets, a 1.2% increase will result in an additional value of $8,000 * 0.012 = $96. The new value of the electronic gadgets would be $8,000 + $96 = $8,096
        4. Now that we have the projected values for both items after their respective market growth rates, we can compare them to determine which option has a higher profit",Node10,4,3,5,8,0.1575292964631021,103,False
" 1. First, we need to determine the initial value of both purchase options. The jewelry costs $5,000 and the electronic gadgets cost $8,000.
        2. Next, calculate the projected increase in value for each item based on their respective market growth rates. For jewelry, the 2.5% increase will be $5,000 * 0.025 = $125. So, the new value of jewelry would be $5,000 + $125 = $5,125 3. Similarly, for electronic gadgets, a 1.2% increase will result in an additional value of $8,000 * 0.012 = $96. The new value of the electronic gadgets would be $8,000 + $96 = $8,096
        4. Now that we have the projected values for both items after their respective market growth rates, we can compare them to determine which one has a higher profit potential. Comparing $",Node11,4,3,5,8,0.2611662939323047,108,False
" 1. First, we need to determine the initial value of both purchase options. The jewelry costs $5,000 and the electronic gadgets cost $8,000.
        2. Next, calculate the projected increase in value for each item based on their respective market growth rates. For jewelry, the 2.5% increase will be $5,000 * 0.025 = $125. So, the new value of jewelry would be $5,000 + $125 = $5,125 3. Similarly for electronic gadgets, a 1.2% increase would be $8,000 * 0.012 = $96. The new value of the gadgets after the increase would be $8,000 + $96 = $8,096
        4. Now that we have calculated the projected values, it's time to compare them to determine which option will yield more profit at the",Node12,4,3,5,8,0.6652886704476819,96,False
" 1. First, we need to determine the initial value of both purchase options. The jewelry costs $5,000 and the electronic gadgets cost $8,000.
        2. Next, calculate the projected increase in value for each item based on their respective market growth rates. For jewelry, the 2.5% increase will be $5,000 * 0.025 = $125. So, the new value of jewelry would be $5,000 + $125 = $5,125 3. Similarly, for electronic gadgets, a 1.2% increase will result in an additional value of $8,000 * 0.012 = $96. The new value of the electronic gadgets would be $8,000 + $96 = $8,096
        4. Now that we have the projected values for both items after their respective market growth rates, we can compare them to determine which option has a higher profit potential. In this case, the jewelry's increased value is $5,1",Node13,3,2,4,6,0.18589460364140753,120,False
" 1. First, we need to determine the initial value of both purchase options. The jewelry costs $5,000 and the electronic gadgets cost $8,000.
        2. Next, calculate the projected increase in value for each item based on their respective market growth rates. For jewelry, the 2.5% increase will be $5,000 * 0.025 = $125. So, the new value of jewelry would be $5,000 + $125 = $5,125 3. Similarly, for electronic gadgets, a 1.2% increase will result in an additional value of $8,000 * 0.012 = $96. The new value of the electronic gadgets would be $8,000 + $96 = $8,096
        4. Now that we have the projected values for both items after their respective market growth rates, we can compare them to determine which option has a higher profit potential. In this case, the jewelry's increased value is $5,1 5. Lastly, if the merchant chooses the more profitable option (jewelry), he will make an additional profit of $625 ($5,125 - $5,000) from his purchase plan at the end of this month.",Node14,3,2,7,9,0.7055399326309022,65,False
" 1. First, we need to determine the initial value of both purchase options. The jewelry costs $5,000 and the electronic gadgets cost $8,000.
        2. Next, calculate the projected increase in value for each item based on their respective market growth rates. For jewelry, the 2.5% increase will be $5,000 * 0.025 = $125. So, the new value of jewelry would be $5,000 + $125 = $5,125 3. Similarly, for electronic gadgets, a 1.2% increase will result in an additional value of $8,000 * 0.012 = $96. The new value of the electronic gadgets would be $8,000 + $96 = $8,096
        4. Now that we have the projected values for both items after their respective market growth rates, we can compare them to determine which option has a higher profit potential. In this case, the jewelry's increased value is $5,1 25, while the electronic gadgets are worth $8,096.
        5. Finally, subtract the initial purchase price from the projected value of each item to find the potential profit for each option. For jewelry, the profit would be $5,125 - $5,000 = $125. For electronic gadgets, the profit would be $8,096 - $8,000 = $96.
        6. Since the merchant wants to maximize",Node15,1,2,5,7,0.36667061196079764,111,False
" 1. First, we need to determine the initial value of both purchase options. The jewelry costs $5,000 and the electronic gadgets cost $8,000.
        2. Next, calculate the projected increase in value for each item based on their respective market growth rates. For jewelry, the 2.5% increase will be $5,000 * 0.025 = $125. So, the new value of jewelry would be $5,000 + $125 = $5,125 3. Similarly, for electronic gadgets, a 1.2% increase will result in an additional value of $8,000 * 0.012 = $96. The new value of the electronic gadgets would be $8,000 + $96 = $8,096
        4. Now that we have the projected values for both items after their respective market growth rates, we can compare them to determine which option has a higher profit potential. In this case, the jewelry's increased value is $5,1 25 while the electronic gadgets' increased value is $8,096.
        5. Finally, calculate the profit for each item by subtracting their initial values from their new projected values. For jewelry, the profit would be $5,125 - $5,000 = $125. And for electronic gadgets, the profit would be $8,096 - $8,000 = $96.
        6. Since the merchant wants to maximize profit within a month, he should choose",Node16,3,2,7,9,0.5318868374712009,118,False
" 1. First, we need to determine the initial value of both purchase options. The jewelry costs $5,000 and the electronic gadgets cost $8,000.
        2. Next, calculate the projected increase in value for each item based on their respective market growth rates. For jewelry, the 2.5% increase will be $5,000 * 0.025 = $125. So, the new value of jewelry would be $5,000 + $125 = $5,125 3. Similarly, for electronic gadgets, a 1.2% increase will result in an additional value of $8,000 * 0.012 = $96. The new value of the electronic gadgets would be $8,000 + $96 = $8,096
        4. Now that we have the projected values for both items after their respective market growth rates, we can compare them to determine which option has a higher profit potential. In this case, the jewelry's increased value is $5,1 25 and electronic gadgets' increased value is $8,096. 
        5. Finally, to calculate the maximum profit for the merchant at the end of this month, he should choose the most profitable option based on its projected increase in value. In this case, the jewelry market has a higher growth rate",Node18,2,2,6,8,0.7531865045450448,67,False
" 1. First, we need to determine the initial value of both purchase options. The jewelry costs $5,000 and the electronic gadgets cost $8,000.
        2. Next, calculate the projected increase in value for each item based on their respective market growth rates. For jewelry, the 2.5% increase will be $5,000 * 0.025 = $125. So, the new value of jewelry would be $5,000 + $125 = $5,125 3. Similarly, for electronic gadgets, a 1.2% increase will result in an additional value of $8,000 * 0.012 = $96. The new value of the electronic gadgets would be $8,000 + $96 = $8,096
        4. Now that we have the projected values for both items after their respective market growth rates, we can compare them to determine which option has a higher profit potential. In this case, the jewelry's increased value is $5,1 25 and the electronic gadgets' increased value is $8,096.
        5. The merchant should choose the purchase plan that maximizes profit at the end of the month. Since the jewelry market has a higher projected increase in value compared to the electronic gadgets market, the merchant would likely opt for purchasing the jewelry worth $5,125.
        6. To find out how much profit this choice will bring, we need to calculate the difference between the initial and final values of the",Node19,2,2,6,8,0.3241260874715104,107,False
" 1. First, we need to determine the initial value of both purchase options. The jewelry costs $5,000 and the electronic gadgets cost $8,000.
        2. Next, calculate the projected increase in value for each item based on their respective market growth rates. For jewelry, the 2.5% increase will be $5,000 * 0.025 = $125. So, the new value of jewelry would be $5,000 + $125 = $5,125 3. Similarly, for electronic gadgets, a 1.2% increase will result in an additional value of $8,000 * 0.012 = $96. The new value of the electronic gadgets would be $8,000 + $96 = $8,096
        4. Now that we have the projected values for both items after their respective market growth rates, we can compare them to determine which option has a higher profit potential. In this case, the jewelry's increased value is $5,1 25, and the electronic gadgets are worth $8,096. The difference in potential profit is $8,096 - $5,125 = $3,071.
        5. The merchant would choose to maximize his profit at the end of this month by purchasing jewelry, as it has a higher potential profit compared to electronic gadgets.",Node20,2,2,6,8,0.788976801715613,113,False
" 1. First, we need to determine the initial value of both purchase options. The jewelry costs $5,000 and the electronic gadgets cost $8,000.
        2. Next, calculate the projected increase in value for each item based on their respective market growth rates. For jewelry, the 2.5% increase will be $5,000 * 0.025 = $125. So, the new value of jewelry would be $5,000 + $125 = $5,125 3. Similarly, for electronic gadgets, a 1.2% increase will result in an additional value of $8,000 * 0.012 = $96. The new value of the electronic gadgets would be $8,000 + $96 = $8,096
        4. Now that we have the projected values for both items after their respective market growth rates, we can compare them to determine which option has a higher profit potential. In this case, the jewelry's increased value is $5,1 25, while the electronic gadgets are worth $8,096.
        5. Finally, subtract the initial purchase price from the projected value of each item to find the potential profit for each option. For jewelry, the profit would be $5,125 - $5,000 = $125. For electronic gadgets, the profit would be $8,096 - $8,000 = $96.
        6. Since the merchant wants to maximize 7. The highest potential profit can be achieved by purchasing the item with the largest profit. In this case, jewelry has a higher profit of $125 compared to electronic gadgets' profit of $96.
        8. Therefore, if the merchant chooses to purchase the jewelry worth $5,000 and sell it for $5,125 at the end of the month, he will make a profit of $125.",Node35,1,1,6,7,0.543858398090908,112,False
" 1. First, we need to determine the initial value of both purchase options. The jewelry costs $5,000 and the electronic gadgets cost $8,000.
        2. Next, calculate the projected increase in value for each item based on their respective market growth rates. For jewelry, the 2.5% increase will be $5,000 * 0.025 = $125. So, the new value of jewelry would be $5,000 + $125 = $5,125 3. Similarly, for electronic gadgets, a 1.2% increase will result in an additional value of $8,000 * 0.012 = $96. The new value of the electronic gadgets would be $8,000 + $96 = $8,096
        4. Now that we have the projected values for both items after their respective market growth rates, we can compare them to determine which option has a higher profit potential. In this case, the jewelry's increased value is $5,1 25, while the electronic gadgets are worth $8,096.
        5. Finally, subtract the initial purchase price from the projected value of each item to find the potential profit for each option. For jewelry, the profit would be $5,125 - $5,000 = $125. For electronic gadgets, the profit would be $8,096 - $8,000 = $96.
        6. Since the merchant wants to maximize 7. profit at the end of this month, we can conclude that choosing jewelry for purchase will result in a higher potential profit of $125 compared to electronic gadgets with a potential profit of $96.",Node36,1,1,6,7,0.10959423653992573,89,False
" 1. First, we need to determine the initial value of both purchase options. The jewelry costs $5,000 and the electronic gadgets cost $8,000.
        2. Next, calculate the projected increase in value for each item based on their respective market growth rates. For jewelry, the 2.5% increase will be $5,000 * 0.025 = $125. So, the new value of jewelry would be $5,000 + $125 = $5,125 3. Similarly, for electronic gadgets, a 1.2% increase will result in an additional value of $8,000 * 0.012 = $96. The new value of the electronic gadgets would be $8,000 + $96 = $8,096
        4. Now that we have the projected values for both items after their respective market growth rates, we can compare them to determine which option has a higher profit potential. In this case, the jewelry's increased value is $5,1 25, while the electronic gadgets are worth $8,096.
        5. Finally, subtract the initial purchase price from the projected value of each item to find the potential profit for each option. For jewelry, the profit would be $5,125 - $5,000 = $125. For electronic gadgets, the profit would be $8,096 - $8,000 = $96.
        6. Since the merchant wants to maximize 7. profit at the end of this month, he should choose the option that provides a higher potential profit. In this case, the jewelry purchase plan has a greater profit at $125 compared to $96 for electronic gadgets.",Node37,1,1,6,7,0.5496558707814495,80,False
" 1. First, we need to determine the initial value of both purchase options. The jewelry costs $5,000 and the electronic gadgets cost $8,000.
        2. Next, calculate the projected increase in value for each item based on their respective market growth rates. For jewelry, the 2.5% increase will be $5,000 * 0.025 = $125. So, the new value of jewelry would be $5,000 + $125 = $5,125 3. Similarly, for electronic gadgets, a 1.2% increase will result in an additional value of $8,000 * 0.012 = $96. The new value of the electronic gadgets would be $8,000 + $96 = $8,096
        4. Now that we have the projected values for both items after their respective market growth rates, we can compare them to determine which option has a higher profit potential. In this case, the jewelry's increased value is $5,1 25, while the electronic gadgets are worth $8,096.
        5. Finally, subtract the initial purchase price from the projected value of each item to find the potential profit for each option. For jewelry, the profit would be $5,125 - $5,000 = $125. For electronic gadgets, the profit would be $8,096 - $8,000 = $96.
        6. Since the merchant wants to maximize 7. the profit, he should choose between these two options by comparing the profits. The highest profit is from purchasing jewelry as it results in a larger gain of $125 compared to electronic gadgets at $96.",Node39,1,1,6,7,0.986835601170782,64,False
" 1. First, we need to determine the initial value of both purchase options. The jewelry costs $5,000 and the electronic gadgets cost $8,000.
        2. Next, calculate the projected increase in value for each item based on their respective market growth rates. For jewelry, the 2.5% increase will be $5,000 * 0.025 = $125. So, the new value of jewelry would be $5,000 + $125 = $5,125 3. Similarly, for electronic gadgets, a 1.2% increase will result in an additional value of $8,000 * 0.012 = $96. The new value of the electronic gadgets would be $8,000 + $96 = $8,096
        4. Now that we have the projected values for both items after their respective market growth rates, we can compare them to determine which option has a higher profit potential. In this case, the jewelry's increased value is $5,1 25, while the electronic gadgets are worth $8,096.
        5. Finally, subtract the initial purchase price from the projected value of each item to find the potential profit for each option. For jewelry, the profit would be $5,125 - $5,000 = $125. For electronic gadgets, the profit would be $8,096 - $8,000 = $96.
        6. Since the merchant wants to maximize 7. his/her profit by making a choice between these two options, we choose the option with the highest potential profit. In this case, jewelry has the higher potential profit of $125 as compared to the electronic gadgets' potential profit of $96.
        Therefore, if",Node40,1,2,6,8,0.929786961405451,61,False
" 1. First, we need to determine the initial value of both purchase options. The jewelry costs $5,000 and the electronic gadgets cost $8,000.
        2. Next, calculate the projected increase in value for each item based on their respective market growth rates. For jewelry, the 2.5% increase will be $5,000 * 0.025 = $125. So, the new value of jewelry would be $5,000 + $125 = $5,125 3. Similarly, for electronic gadgets, a 1.2% increase will result in an additional value of $8,000 * 0.012 = $96. The new value of the electronic gadgets would be $8,000 + $96 = $8,096
        4. Now that we have the projected values for both items after their respective market growth rates, we can compare them to determine which option has a higher profit potential. In this case, the jewelry's increased value is $5,1 25, while the electronic gadgets are worth $8,096.
        5. Finally, subtract the initial purchase price from the projected value of each item to find the potential profit for each option. For jewelry, the profit would be $5,125 - $5,000 = $125. For electronic gadgets, the profit would be $8,096 - $8,000 = $96.
        6. Since the merchant wants to maximize 7. profit at the end of this month, he should choose the option with a higher profit potential. In this case, the jewelry has a greater profit of $125 compared to the electronic gadgets' profit of $96. Therefore, the merchant should purchase the jewelry worth $5,000 to maximize his profit at the end of the month.",Node41,1,1,6,7,0.4055722964525764,92,False
" 1. First, we need to determine the initial value of both purchase options. The jewelry costs $5,000 and the electronic gadgets cost $8,000.
        2. Next, calculate the projected increase in value for each item based on their respective market growth rates. For jewelry, the 2.5% increase will be $5,000 * 0.025 = $125. So, the new value of jewelry would be $5,000 + $125 = $5,125 3. Similarly, for electronic gadgets, a 1.2% increase will result in an additional value of $8,000 * 0.012 = $96. The new value of the electronic gadgets would be $8,000 + $96 = $8,096
        4. Now that we have the projected values for both items after their respective market growth rates, we can compare them to determine which option has a higher profit potential. In this case, the jewelry's increased value is $5,1 25, while the electronic gadgets are worth $8,096.
        5. Finally, subtract the initial purchase price from the projected value of each item to find the potential profit for each option. For jewelry, the profit would be $5,125 - $5,000 = $125. For electronic gadgets, the profit would be $8,096 - $8,000 = $96.
        6. Since the merchant wants to maximize 7. The highest potential profit can be achieved by purchasing the item with the largest profit. In this case, jewelry has a higher profit of $125 compared to electronic gadgets' profit of $96.
        8. Therefore, if the merchant chooses to purchase the jewelry worth $5,000 and sell it for $5,125 at the end of the month, he will make a profit of $125. 9. It is important to note that this calculation assumes no other costs or external factors are involved in the decision-making process.",Node42,0,0,6,6,0.5555504218975068,110,False
