continuation,Node Path,V Score,H Score,G Score,F Score,Temperature,Max Tokens,Wrong Solution Flag
" 1. We know that there are 60 dogs and twice as many cats (2 * 60 = 120).
        2. The combined number of pet dogs and cats is 60 + 1",Node0,5,9,5,14,0.3370393632769736,47,False
" 1. Let's first define variables to make it easier to work with the problem. We have 'rabbits', 'dogs', 'cats', 'total_pets'.
        2. We know that rabbits = dogs + cats - 12, where",Node1,3,8,3,11,0.28090722965157366,57,False
" 1. Let's define some variables to make it easier to work with the given information. We have 'rabbits', 'dogs', 'cats', and 'total_pets'. The number of rabbits is twelve less than the combined number of dogs and cats, which means we can write this as: rabbits = (dogs + cats) - 12
        2. Since there are two cats for every dog, we can represent the relationship between dogs and cats as: cats = 2 * dogs",Node2,3,7,3,10,0.25102690684974516,110,False
" 1. We know that the difference between the number of rabbits and the sum of dogs and cats is twelve. So let's call the number of rabbits ""r"", the sum of dogs and cats as ""d+c"" (where d = dogs and c = cats). Our equation looks like this: r = d+c - 12",Node4,6,8,6,14,0.8372360238184015,73,False
" 1. Let's denote the number of pet dogs as D, the number of pet cats as C, and the number of rabbits as R. We know that there are twelve fewer rabbits than the combined number of dogs and cats",Node5,2,9,2,11,0.6104766042194123,48,False
" 1. Let's first find out the number of cats by multiplying the number of dogs (60) by the ratio of cats per dog (2). So, 60 * 2 = 120 cats.",Node6,2,6,2,8,0.3351000896380346,50,False
" 1. Let's first find out the number of cats by multiplying the number of dogs (60) by the ratio of cats per dog (2). So, 60 * 2 = 120 cats. 2. Now we know there are 120 cats and 60 dogs in total. We also have information that the combined number of pet dogs and cats is 12 less than the number of rabbits pets. Let's denote this unknown number as '",Node12,2,1,4,5,0.2819792810183367,55,False
" 1. Let's first find out the number of cats by multiplying the number of dogs (60) by the ratio of cats per dog (2). So, 60 * 2 = 120 cats. 2. Now we know there are 120 cats and 60 dogs in total. We also have information that the combined number of pet dogs and cats is 12 less than the number of rabbits pets. Let's denote this unknown number as ' 3. Rewrite the equation: Number of rabbit pets = Combined number of dog & cat pets + 12. 4. Add the known values from previous steps: Number of",Node14,7,9,11,20,0.6348244639612292,40,False
" 1. Let's first find out the number of cats by multiplying the number of dogs (60) by the ratio of cats per dog (2). So, 60 * 2 = 120 cats. 2. Now we know there are 120 cats and 60 dogs in total. We also have information that the combined number of pet dogs and cats is 12 less than the number of rabbits pets. Let's denote this unknown number as ' 3. Add the number of dogs (60) and cats (120) to find the combined number of dog and cat pets: 60 + 120 = 180.",Node18,7,9,11,20,0.20591752425345022,44,False
" 1. Let's define some variables to make it easier to work with the given information. We have 'rabbits', 'dogs', 'cats', and 'total_pets'. The number of rabbits is twelve less than the combined number of dogs and cats, which means we can write this as: rabbits = (dogs + cats) - 12
        2. Since there are two cats for every dog, we can represent the relationship between dogs and cats as: cats = 2 * dogs 3. We know that the number of dogs is 60, so now we can find the number of cats with the equation from step 2: cats = 2 * 60 -> cats = 120
        4. Now that we have both the number of dogs",Node21,1,5,4,9,0.980005070446636,59,False
" 1. Let's define some variables to make it easier to work with the given information. We have 'rabbits', 'dogs', 'cats', and 'total_pets'. The number of rabbits is twelve less than the combined number of dogs and cats, which means we can write this as: rabbits = (dogs + cats) - 12
        2. Since there are two cats for every dog, we can represent the relationship between dogs and cats as: cats = 2 * dogs 3. Now we know that there are 60 dogs in the neighborhood. So, we can find the number of cats using our equation from step 2: cats = 2 * 60 = 120
        4. We have all the information necessary to calculate the total number of pets. First, let's use the given relationship between rabbits and dogs & cats to find out how many rabbits there are: rabbits = (dog",Node22,1,5,4,9,0.4552126860441761,95,False
" 1. Let's define some variables to make it easier to work with the given information. We have 'rabbits', 'dogs', 'cats', and 'total_pets'. The number of rabbits is twelve less than the combined number of dogs and cats, which means we can write this as: rabbits = (dogs + cats) - 12
        2. Since there are two cats for every dog, we can represent the relationship between dogs and cats as: cats = 2 * dogs 3. Now that we have a relationship between dogs and cats, we can substitute it into our equation for rabbits to get rid of 'cats': rabbits = (dogs + 2 * dogs) - 12
        4. Combine the terms with dogs: rabbits = 3 * dogs - 12
        5.",Node23,1,4,4,8,0.21002595702412807,73,False
" 1. Let's define some variables to make it easier to work with the given information. We have 'rabbits', 'dogs', 'cats', and 'total_pets'. The number of rabbits is twelve less than the combined number of dogs and cats, which means we can write this as: rabbits = (dogs + cats) - 12
        2. Since there are two cats for every dog, we can represent the relationship between dogs and cats as: cats = 2 * dogs 3. Now, we have three equations to solve for the unknown variables: rabbits = (60 + 2 * 60) - 12, cats = 2 * 60, total_pets = rabbits + dogs + cats
        4. Let's substitute the values from step 3 into the first equation and simplify it: rabbits = (6",Node24,1,3,4,7,0.19793692633206028,82,False
" 1. Let's define some variables to make it easier to work with the given information. We have 'rabbits', 'dogs', 'cats', and 'total_pets'. The number of rabbits is twelve less than the combined number of dogs and cats, which means we can write this as: rabbits = (dogs + cats) - 12
        2. Since there are two cats for every dog, we can represent the relationship between dogs and cats as: cats = 2 * dogs 3. Now we have enough information to find the total number of pets in the neighborhood. We know that there are 60 dogs, so we can calculate the number of cats and rabbits based on our defined relationships: cats = 2 * 60 = 120, rabbits = (",Node25,2,5,5,10,0.5119476375032186,63,False
" 1. Let's define some variables to make it easier to work with the given information. We have 'rabbits', 'dogs', 'cats', and 'total_pets'. The number of rabbits is twelve less than the combined number of dogs and cats, which means we can write this as: rabbits = (dogs + cats) - 12
        2. Since there are two cats for every dog, we can represent the relationship between dogs and cats as: cats = 2 * dogs 3. We know that the number of dogs is 60. So now we have: cats = 2 * 60 (dogs) = 120 (cats)
        4. Now, let",Node26,1,5,4,9,0.34084742060734696,47,False
" 1. Let's define some variables to make it easier to work with the given information. We have 'rabbits', 'dogs', 'cats', and 'total_pets'. The number of rabbits is twelve less than the combined number of dogs and cats, which means we can write this as: rabbits = (dogs + cats) - 12
        2. Since there are two cats for every dog, we can represent the relationship between dogs and cats as: cats = 2 * dogs 3. We know that the number of dogs is 60. So, using our equation from step 2, we get the number of cats: cats = 2 * 60 = 120
        4. Now, let's find the combined number of dogs and cats: total_dogs_and_cats = dogs + cats = 60 + 120 = 180
        5. We know that rabbits are twelve less than the combined number of dogs and cats, so we can calculate the number of rab",Node27,1,2,4,6,0.15395236776397225,118,False
" 1. Let's define some variables to make it easier to work with the given information. We have 'rabbits', 'dogs', 'cats', and 'total_pets'. The number of rabbits is twelve less than the combined number of dogs and cats, which means we can write this as: rabbits = (dogs + cats) - 12
        2. Since there are two cats for every dog, we can represent the relationship between dogs and cats as: cats = 2 * dogs 3. We know that the number of dogs is 60. So, using our equation from step 2, we get the number of cats: cats = 2 * 60 = 120
        4. Now, let's find the combined number of dogs and cats: total_dogs_and_cats = dogs + cats = 60 + 120 = 180
        5. We know that rabbits are twelve less than the combined number of dogs and cats, so we can calculate the number of rab 6. rabbits = (total_dogs_and_cats) - 12 = 180 - 12 = 168
        7. Finally, to find the total number of pets in the neighborhood, we add up all the individual numbers: total_pets = dogs + cats + rabbits = 60 + 120 + 1",Node28,3,8,7,15,0.35707991700515707,82,False
" 1. Let's define some variables to make it easier to work with the given information. We have 'rabbits', 'dogs', 'cats', and 'total_pets'. The number of rabbits is twelve less than the combined number of dogs and cats, which means we can write this as: rabbits = (dogs + cats) - 12
        2. Since there are two cats for every dog, we can represent the relationship between dogs and cats as: cats = 2 * dogs 3. We know that the number of dogs is 60. So, using our equation from step 2, we get the number of cats: cats = 2 * 60 = 120
        4. Now, let's find the combined number of dogs and cats: total_dogs_and_cats = dogs + cats = 60 + 120 = 180
        5. We know that rabbits are twelve less than the combined number of dogs and cats, so we can calculate the number of rab 6. rabbits = (total_dogs_and_cats) - 12 = 180 - 12 = 168
        7. Finally, to find the total number of pets in the neighborhood,",Node29,3,8,7,15,0.6781843704182487,51,False
" 1. Let's define some variables to make it easier to work with the given information. We have 'rabbits', 'dogs', 'cats', and 'total_pets'. The number of rabbits is twelve less than the combined number of dogs and cats, which means we can write this as: rabbits = (dogs + cats) - 12
        2. Since there are two cats for every dog, we can represent the relationship between dogs and cats as: cats = 2 * dogs 3. We know that the number of dogs is 60. So, using our equation from step 2, we get the number of cats: cats = 2 * 60 = 120
        4. Now, let's find the combined number of dogs and cats: total_dogs_and_cats = dogs + cats = 60 + 120 = 180
        5. We know that rabbits are twelve less than the combined number of dogs and cats, so we can calculate the number of rab 5. We know that rabbits are twelve less than the combined number of dogs and cats, so we can calculate the number of rabbits: rabbits = total_dogs_and_cats - 12 = 180 - 12 = 168
        6. Finally, let's find the total number of pets in the neighborhood by adding all three types together: total_p",Node30,4,7,8,15,0.9017433962814031,87,False
" 1. Let's define some variables to make it easier to work with the given information. We have 'rabbits', 'dogs', 'cats', and 'total_pets'. The number of rabbits is twelve less than the combined number of dogs and cats, which means we can write this as: rabbits = (dogs + cats) - 12
        2. Since there are two cats for every dog, we can represent the relationship between dogs and cats as: cats = 2 * dogs 3. We know that the number of dogs is 60. So, using our equation from step 2, we get the number of cats: cats = 2 * 60 = 120
        4. Now, let's find the combined number of dogs and cats: total_dogs_and_cats = dogs + cats = 60 + 120 = 180
        5. We know that rabbits are twelve less than the combined number of dogs and cats, so we can calculate the number of rab 6. rabbits = (total_dogs_and_cats) - 12 = 180 - 12 = 168
        7. Finally, to find the total number of pets in the neighborhood, we add up all the individual numbers of pets: total_pets = dogs + cats + rabbits = 60 + 120 + 168 = 348",Node32,0,0,4,4,0.12531857153672465,91,False
