continuation,Node Path,V Score,H Score,G Score,F Score,Temperature,Max Tokens,Wrong Solution Flag
" 1. First, we need to determine the number of eggs needed for a single omelet. Claire uses 3 eggs per omelet.
        2. Next, we need to calculate how many omelets she makes in a day. Since she eats an omelet every morning for breakfast, this means she makes one",Node0,1,8,1,9,0.3958347040239495,69,False
" 1. First, we need to determine how many eggs are in one dozen. A dozen is equal to 12 eggs.
        2. Next, we know that Claire makes a 3 egg omelet every morning for breakfast. To find out how many eggs she uses per day",Node1,1,8,1,9,0.27441259962116726,59,False
" 1. First, we need to determine how many eggs are in a dozen. One dozen eggs consists of 12 eggs.
        2. Next, let's consider the number of eggs Claire uses daily. She makes an omelet with 3 eggs each morning.
        3. Calculate the total number of eggs used for breakfast during those days by multiplying the daily quantity (3 eggs) and the number",Node2,1,6,1,7,0.8906818722943851,87,False
" 1. First, let's determine how many eggs are in a dozen. There are 12 eggs in a dozen.
        2. Next, we need to find out how many eggs Claire uses daily for her omelet. She makes an omelet with 3 eggs every morning.
        3. Now, we need to calculate the total number of eggs she consumes in one day. To do this, multiply the number",Node3,1,7,1,8,0.39905112593735415,92,False
" 1. First, we need to determine how many days are in 4 weeks. There are 7 days in a week, so 4 weeks would have 4 * 7 = 28 days.
        2. Since Claire makes an omelet every morning, that means she will make",Node4,1,6,1,7,0.7846492574794659,62,False
" 1. First, we need to determine the number of eggs in one dozen. A dozen is equal to 12 eggs.
        2. Next, we know Claire makes a 3 egg omelet every morning for breakfast. So, we need to multiply the number of eggs per omelet (3) by the number",Node5,1,8,1,9,0.24685598104556927,69,False
" 1. First, let's determine how many eggs are in one dozen. There are 12 eggs in a dozen.
        2. Next, we need to find out the total number of eggs Claire uses daily for her omelet. She makes an omelet with 3 eggs every morning. So, she uses 3 * 7 = 21 eggs per week.
        3. Now, let's calculate how many weeks are in 4 weeks",Node6,1,5,1,6,0.24965346465511917,99,False
" 1. First, let's determine how many eggs are in one dozen. There are 12 eggs in a dozen.
        2. Next, we need to find out the total number of eggs Claire uses daily for her omelet. She makes an omelet with 3 eggs every morning. So, she uses 3 * 7 = 21 eggs per week.
        3. Now, let's calculate how many weeks are in 4 weeks 4. There are 4 weeks in 4 weeks, so no additional conversion is needed.
        5. To find out the total number of eggs Claire will eat in 4 weeks, we need to multiply the number of eggs she uses per week by the number of weeks. So, 21 * 4 = 84 eggs.
        6. Finally, let's",Node7,1,3,2,5,0.2233017471494263,81,False
" 1. First, let's determine how many eggs are in one dozen. There are 12 eggs in a dozen.
        2. Next, we need to find out the total number of eggs Claire uses daily for her omelet. She makes an omelet with 3 eggs every morning. So, she uses 3 * 7 = 21 eggs per week.
        3. Now, let's calculate how many weeks are in 4 weeks 4. Four weeks is equal to 4 * 7 = 28 days.
        5. To find out the total number of eggs Claire will eat in 4 weeks, we need to multiply the number of eggs she uses per week by the number of weeks in those 4 weeks. So, 21 eggs/week * 4 weeks = 84 eggs.
        6. Finally, let's convert this total number of eggs",Node8,1,3,2,5,0.22192462467704788,95,False
" 1. First, let's determine how many eggs are in one dozen. There are 12 eggs in a dozen.
        2. Next, we need to find out the total number of eggs Claire uses daily for her omelet. She makes an omelet with 3 eggs every morning. So, she uses 3 * 7 = 21 eggs per week.
        3. Now, let's calculate how many weeks are in 4 weeks 4. Since there are 7 days in a week, and we have 4 weeks, there will be 4 * 7 = 28 days in these 4 weeks.
        5. To find out the total number of eggs Claire uses during this period, multiply the daily egg usage by the",Node10,1,5,2,7,0.40649595235430946,64,False
" 1. First, let's determine how many eggs are in one dozen. There are 12 eggs in a dozen.
        2. Next, we need to find out the total number of eggs Claire uses daily for her omelet. She makes an omelet with 3 eggs every morning. So, she uses 3 * 7 = 21 eggs per week.
        3. Now, let's calculate how many weeks are in 4 weeks 4. Finally, we can find out the total number of eggs Claire eats by multiplying the weekly egg usage by the number of weeks and then dividing that value by the number of eggs in a dozen (since one dozen = 12): Total eggs = (Weekly usage * Weeks) / Dozens of eggs per dozen
           Total eggs = (21 eggs * 4 weeks) / 12 eggs per dozen =",Node11,1,3,2,5,0.8989765746615365,92,False
" 1. First, let's determine how many eggs are in one dozen. There are 12 eggs in a dozen.
        2. Next, we need to find out the total number of eggs Claire uses daily for her omelet. She makes an omelet with 3 eggs every morning. So, she uses 3 * 7 = 21 eggs per week.
        3. Now, let's calculate how many weeks are in 4 weeks 4. There are 4 weeks in 4 weeks, so no additional calculation is needed for this part.
        5. Finally, we need to find out the total number of eggs Claire will eat in 4 weeks. To do that, multiply the number of eggs she uses per week by the",Node12,1,5,2,7,0.1517681281980634,62,False
" 1. First, let's determine how many eggs are in one dozen. There are 12 eggs in a dozen.
        2. Next, we need to find out the total number of eggs Claire uses daily for her omelet. She makes an omelet with 3 eggs every morning. So, she uses 3 * 7 = 21 eggs per week.
        3. Now, let's calculate how many weeks are in 4 weeks 4. There are 4 weeks in 4 weeks.
        5. To find the total number of eggs Claire will eat in those 4 weeks, we need to multiply the number of",Node13,1,5,2,7,0.28546047885057413,40,False
" 1. First, let's determine how many eggs are in one dozen. There are 12 eggs in a dozen.
        2. Next, we need to find out the total number of eggs Claire uses daily for her omelet. She makes an omelet with 3 eggs every morning. So, she uses 3 * 7 = 21 eggs per week.
        3. Now, let's calculate how many weeks are in 4 weeks 4. There are 4 weeks in 4 weeks, so no additional conversion is needed.
        5. To find out the total number of eggs Claire will eat in 4 weeks, we need to multiply the number of eggs she uses per week by the number of weeks. So, 21 * 4 = 84 eggs.
        6. Finally, let's 7. divide this number by 12 (the number of eggs in one dozen) to get the number of dozens of eggs. Therefore, Claire will eat roughly 84 / 12 = 7 dozens of eggs during those 4 weeks.",Node14,2,2,4,6,0.9905543326612017,64,False
" 1. First, let's determine how many eggs are in one dozen. There are 12 eggs in a dozen.
        2. Next, we need to find out the total number of eggs Claire uses daily for her omelet. She makes an omelet with 3 eggs every morning. So, she uses 3 * 7 = 21 eggs per week.
        3. Now, let's calculate how many weeks are in 4 weeks 4. There are 4 weeks in 4 weeks, so no additional conversion is needed.
        5. To find out the total number of eggs Claire will eat in 4 weeks, we need to multiply the number of eggs she uses per week by the number of weeks. So, 21 * 4 = 84 eggs.
        6. Finally, let's 7. convert this number into dozens of eggs. To do that, we divide the total number of eggs (84) by the number of eggs in a dozen (12). This gives us 84 / 12 =",Node15,3,2,5,7,0.33612393669431717,49,False
" 1. First, let's determine how many eggs are in one dozen. There are 12 eggs in a dozen.
        2. Next, we need to find out the total number of eggs Claire uses daily for her omelet. She makes an omelet with 3 eggs every morning. So, she uses 3 * 7 = 21 eggs per week.
        3. Now, let's calculate how many weeks are in 4 weeks 4. There are 4 weeks in 4 weeks, so no additional conversion is needed.
        5. To find out the total number of eggs Claire will eat in 4 weeks, we need to multiply the number of eggs she uses per week by the number of weeks. So, 21 * 4 = 84 eggs.
        6. Finally, let's 7. convert this amount back into dozens. To do that, divide the total number of eggs (84) by how many eggs are in a dozen (12). This will give us the number of dozens: 84 / 1",Node16,4,4,6,10,0.9184069112905379,50,False
" 1. First, let's determine how many eggs are in one dozen. There are 12 eggs in a dozen.
        2. Next, we need to find out the total number of eggs Claire uses daily for her omelet. She makes an omelet with 3 eggs every morning. So, she uses 3 * 7 = 21 eggs per week.
        3. Now, let's calculate how many weeks are in 4 weeks 4. There are 4 weeks in 4 weeks, so no additional conversion is needed.
        5. To find out the total number of eggs Claire will eat in 4 weeks, we need to multiply the number of eggs she uses per week by the number of weeks. So, 21 * 4 = 84 eggs.
        6. Finally, let's 7. convert this number back to dozens. We know that there are 12 eggs in a dozen. To find how many dozens this is equivalent to, we divide by the total number of eggs per dozen. So, 84 / 12 = 7 dozens.

        Claire will eat 7 dozens of eggs in 4 weeks.",Node17,1,0,3,3,0.8909902635002793,95,False
