continuation,Node Path,V Score,H Score,G Score,F Score,Temperature,Max Tokens,Wrong Solution Flag
" 1. First, let's understand the initial situation: Lee runs 400-meter hurdles two seconds faster than Gerald. So, if Gerald runs it in X seconds, Lee would run it in (X - 2) seconds.
        2. Now, Gerald has improved his speed by 10% due to a change in diet. We need to find out how much faster he can run now compared to before the improvement",Node0,3,6,3,9,0.12093264089754752,96,False
" 1. First, we need to determine the time difference between Lee and Gerald before Gerald's diet improvement. Let's call this difference 't'. So, t = Lee's time - Gerald's initial time, which equals 38 seconds (Lee's time) - unspecified time",Node1,6,9,6,15,0.6150813581391597,67,False
" 1. First, we know that initially Lee ran 2 seconds faster than Gerald for the same distance (400-meter hurdles).
        2. With Gerald improving his speed by 10%, it means Gerald's new speed is 10% more",Node2,5,8,5,13,0.596743476364457,61,False
" 1. Initially, Lee was running the 400-meter hurdles two seconds faster than Gerald. So, Gerald's initial speed was 38 - 2 = 36 seconds.
        2. Now, Gerald has improved his speed by 10%, meaning he is now 10% faster compared to before. To calculate this new improved speed, we need to add 10% of his previous time (3",Node3,1,4,1,5,0.7367854387680448,98,False
" 1. First, let's analyze the given information about Lee and Gerald's performances before Gerald changed his diet. We know that Lee could run the 400-meter hurdles 2 seconds faster than Gerald.",Node5,7,10,7,17,0.6429180616144947,51,False
" 1. First, we need to find out how much faster Lee was initially compared to Gerald before Gerald's diet change. We know that Lee used to be able to run two seconds faster than Gerald.
        2. Now, let's consider the new situation where Gerald has improved his speed by 10%. We need to",Node6,4,7,4,11,0.21006044242530886,72,False
" 1. First, let's understand the initial situation: Lee runs 400-meter hurdles two seconds faster than Gerald. So, if Gerald runs it in X seconds, Lee would run it in (X - 2) seconds.
        2. Now, Gerald has improved his speed by 10% due to a change in diet. We need to find out how much faster he can run now compared to before the improvement 3. Let's denote the new time for Gerald as Y seconds. To calculate the difference between Y and X (the old time), we can use the formula: Y = 1.1X, where 1.1 is the factor representing the 10% increase in speed.
        4. Now that we know how much faster Gerald can run after his diet change, we need to find out how fast he can run the 400-meter hurdles with this new speed. We'll use Lee's current time of 38",Node14,2,7,5,12,0.08371720550256267,120,False
" 1. First, let's understand the initial situation: Lee runs 400-meter hurdles two seconds faster than Gerald. So, if Gerald runs it in X seconds, Lee would run it in (X - 2) seconds.
        2. Now, Gerald has improved his speed by 10% due to a change in diet. We need to find out how much faster he can run now compared to before the improvement 3. To calculate this, we'll multiply his initial speed (X seconds) by the percentage increase (10%) and then add it to X: (X * 0.10) + X = 0.1X + X
        4. Now, let's rewrite the equation with only one variable for Gerald's improved time: Y = 0.1X + X
        5. We",Node15,3,6,6,12,0.43675303931701404,91,False
" 1. First, let's understand the initial situation: Lee runs 400-meter hurdles two seconds faster than Gerald. So, if Gerald runs it in X seconds, Lee would run it in (X - 2) seconds.
        2. Now, Gerald has improved his speed by 10% due to a change in diet. We need to find out how much faster he can run now compared to before the improvement 3. Let's denote the new time for Gerald as Y seconds. To calculate the difference between X and Y (the improvement), we use the formula: Y = 1.1 * X, where 1.1",Node16,2,7,5,12,0.062151802436964165,47,False
" 1. First, let's understand the initial situation: Lee runs 400-meter hurdles two seconds faster than Gerald. So, if Gerald runs it in X seconds, Lee would run it in (X - 2) seconds.
        2. Now, Gerald has improved his speed by 10% due to a change in diet. We need to find out how much faster he can run now compared to before the improvement 3. Let's denote the new time Gerald runs the race in as Y seconds. To calculate his improved speed, we can use the concept of relative speed: (Y - X) / X = 10% improvement
        4. Solving for Y: Y = X * (1 + 10%) = X * 1.1
        So, the new time Gerald runs the race is (X * 1.1) seconds. Since he ran",Node17,1,6,4,10,0.8249705640976612,100,False
" 1. First, let's understand the initial situation: Lee runs 400-meter hurdles two seconds faster than Gerald. So, if Gerald runs it in X seconds, Lee would run it in (X - 2) seconds.
        2. Now, Gerald has improved his speed by 10% due to a change in diet. We need to find out how much faster he can run now compared to before the improvement 3. Let Y be the new time Gerald takes to run 400-meter hurdles with the improved speed. Since we're assuming 10% increase, his speed has increased by a factor of (1 + 0.1) = 1.1. So now, he runs at a rate that is 10% faster than before",Node20,2,7,5,12,0.9018882540497004,78,False
" 1. First, let's understand the initial situation: Lee runs 400-meter hurdles two seconds faster than Gerald. So, if Gerald runs it in X seconds, Lee would run it in (X - 2) seconds.
        2. Now, Gerald has improved his speed by 10% due to a change in diet. We need to find out how much faster he can run now compared to before the improvement 3. To calculate this, we'll multiply his initial speed (X seconds) by the percentage increase (10%) and then add it to X: (X * 0.10) + X = 0.1X + X
        4. Now, let's rewrite the equation with only one variable for Gerald's improved time: Y = 0.1X + X
        5. We 6. We also know that Lee runs in 38 seconds, which means 38 - 2 = (Y - 2) seconds for Gerald due to his diet change. So we can substitute these values into our equation: 36 = 0.1X + X - 2
        7. Now, solve for X (Gerald's time with improved speed): Subtract 0.1X from both sides",Node45,3,6,9,15,0.9935562479626179,93,False
" 1. First, let's understand the initial situation: Lee runs 400-meter hurdles two seconds faster than Gerald. So, if Gerald runs it in X seconds, Lee would run it in (X - 2) seconds.
        2. Now, Gerald has improved his speed by 10% due to a change in diet. We need to find out how much faster he can run now compared to before the improvement 3. To calculate this, we'll multiply his initial speed (X seconds) by the percentage increase (10%) and then add it to X: (X * 0.10) + X = 0.1X + X
        4. Now, let's rewrite the equation with only one variable for Gerald's improved time: Y = 0.1X + X
        5. We 6. know that Lee runs the 400-meter hurdles in 38 seconds. So, we can substitute this value into our equation to find out how fast Gerald can run with his improved diet: 38 = 0.1X + X
        7.",Node47,3,7,9,16,0.06316525732998002,62,False
" 1. First, let's understand the initial situation: Lee runs 400-meter hurdles two seconds faster than Gerald. So, if Gerald runs it in X seconds, Lee would run it in (X - 2) seconds.
        2. Now, Gerald has improved his speed by 10% due to a change in diet. We need to find out how much faster he can run now compared to before the improvement 3. To calculate this, we'll multiply his initial speed (X seconds) by the percentage increase (10%) and then add it to X: (X * 0.10) + X = 0.1X + X
        4. Now, let's rewrite the equation with only one variable for Gerald's improved time: Y = 0.1X + X
        5. We 6. know that Lee runs the 400-meter hurdles in 38 seconds. So, we can substitute this value into our equation to find out how fast Gerald can run with his improved diet:",Node48,2,3,8,11,0.15259352144973826,47,False
" 1. First, let's understand the initial situation: Lee runs 400-meter hurdles two seconds faster than Gerald. So, if Gerald runs it in X seconds, Lee would run it in (X - 2) seconds.
        2. Now, Gerald has improved his speed by 10% due to a change in diet. We need to find out how much faster he can run now compared to before the improvement 3. Let's denote the new time for Gerald as Y seconds. To calculate the difference between X and Y (the improvement), we use the formula: Y = 1.1 * X, where 1.1 4. Now, let's substitute Lee's initial running time into this equation: (X - 2) = 1.1 * X. We can rearrange the equation to solve for X: X = (X - 2) / (1.1 - 1).
        5. Solving for X, we get X = 38 seconds. This means that Gerald's initial time was 38 seconds before his diet change.
        6. Now, let's calculate the new time Y with the",Node62,2,4,7,11,0.24912685749831553,114,False
" 1. First, we know that initially Lee ran 2 seconds faster than Gerald for the same distance (400-meter hurdles).
        2. With Gerald improving his speed by 10%, it means Gerald's new speed is 10% more 3. We are given that Lee runs the 400-meter hurdles in 38 seconds.
        4. To find out how fast Gerald can run with his improved diet, we need",Node80,4,9,9,18,0.1621589589315825,45,False
" 1. First, we know that initially Lee ran 2 seconds faster than Gerald for the same distance (400-meter hurdles).
        2. With Gerald improving his speed by 10%, it means Gerald's new speed is 10% more 3. We are given that Lee runs the 400-meter hurdles in 38 seconds, so we can calculate his initial speed (before Gerald improved) as follows: Speed = Distance / Time, so Lee's initial speed = 400 meters / 36 seconds = 11.11 m/s
        4. Now that Gerald has improved his speed by 10",Node81,3,9,8,17,0.028519578688687486,91,False
" 1. First, we know that initially Lee ran 2 seconds faster than Gerald for the same distance (400-meter hurdles).
        2. With Gerald improving his speed by 10%, it means Gerald's new speed is 10% more 3. Let's represent Lee and Gerald's initial times as T_Lee and T_Gerald, respectively.
            Initial difference: T_Lee - T_Gerald = 2 seconds (since Lee ran 2 seconds faster than",Node82,4,9,9,18,0.9015217838535199,56,False
" 1. First, we need to determine the time difference between Lee and Gerald before Gerald's diet improvement. Let's call this difference 't'. So, t = Lee's time - Gerald's initial time, which equals 38 seconds (Lee's time) - unspecified time 2. We know that Lee used to be able to run the 400-meter hurdles two seconds faster than Gerald initially. So, t = 2 seconds.
        3. Now, we need to find out how much faster Gerald can run after his diet improvement. Let's call this difference 'f'. So, f = (10% of Gerald's initial time)",Node84,3,7,9,16,0.04686809742731657,87,False
" 1. First, we need to determine the time difference between Lee and Gerald before Gerald's diet improvement. Let's call this difference 't'. So, t = Lee's time - Gerald's initial time, which equals 38 seconds (Lee's time) - unspecified time 2. We know that Lee used to be able to run the 400-meter hurdles two seconds faster than Gerald, so t = 2 seconds.
        3. Now, we need to consider Gerald's improved speed due to his diet change. His new speed is 10% higher than his initial speed. So, let's call this improvement 'x'. We can",Node85,4,8,10,18,0.2642168065002133,86,False
" 1. First, we need to determine the time difference between Lee and Gerald before Gerald's diet improvement. Let's call this difference 't'. So, t = Lee's time - Gerald's initial time, which equals 38 seconds (Lee's time) - unspecified time 2. We know that Lee used to be able to run the 400-meter hurdles two seconds faster than Gerald initially. This means t = 2 seconds.
        3. Now, we need to find out how much time Gerald's speed improved by after changing his diet. Let's call this improvement 'i'. So, i = Gerald's new speed (improved) - Gerald's initial speed, which equals unspecified time +",Node86,5,9,11,20,0.32440562064040734,104,False
" 1. First, we need to determine the time difference between Lee and Gerald before Gerald's diet improvement. Let's call this difference 't'. So, t = Lee's time - Gerald's initial time, which equals 38 seconds (Lee's time) - unspecified time 2. We know that Lee was initially two seconds faster than Gerald, so we can set up the equation: t = 2 seconds (initial difference)
        3. Now that we have an equation with one unknown variable (t), we need to solve it for 't'. To do this, subtract 2 seconds from both sides of the equation: t - 2 = 0
        4. Add 2 seconds to both sides of the equation to isolate 't': t = 2
        5. This means that before Ger",Node87,6,6,12,18,0.47481367318817347,114,False
" 1. First, we need to determine the time difference between Lee and Gerald before Gerald's diet improvement. Let's call this difference 't'. So, t = Lee's time - Gerald's initial time, which equals 38 seconds (Lee's time) - unspecified time 2. We know that Lee used to be able to run the 400-meter hurdles two seconds faster than Gerald initially, so t = 2 seconds.
        3. Now we need to calculate how much faster Gerald is after his diet improvement. Let's call this difference 'f'. So, f = (Gerald's improved time - Gerald's initial time) / Gerald'",Node88,5,8,11,19,0.2614372306124976,91,False
" 1. First, we need to determine the time difference between Lee and Gerald before Gerald's diet improvement. Let's call this difference 't'. So, t = Lee's time - Gerald's initial time, which equals 38 seconds (Lee's time) - unspecified time 2. We are given that Lee was initially faster than Gerald by 2 seconds in the hurdles, meaning Lee had a time advantage of 2 seconds. Thus, t = 2 seconds.
        3. Now we know the time difference between them",Node90,2,5,8,13,0.9830317709354789,54,False
" 1. First, we need to determine the time difference between Lee and Gerald before Gerald's diet improvement. Let's call this difference 't'. So, t = Lee's time - Gerald's initial time, which equals 38 seconds (Lee's time) - unspecified time 2. We are given that Lee was initially faster than Gerald by 2 seconds in the hurdles, meaning Lee had a time advantage of 2 seconds. Thus, t = 2 seconds.
        3. Now we know the time difference between them 4. Gerald's initial speed is not specified, but after his diet improvement, he became 10% faster. So, his new speed is 110% of his previous speed (100% + 10%).
        5. To find out how fast Gerald can run the 400-meter hurdles with his improved diet, we need to consider the time difference between Lee and Gerald after Gerald's improvement. Let's call this new difference 't2'. So, t2 = Lee's time",Node91,4,7,12,19,0.14736504238544346,120,False
" 1. First, we need to determine the time difference between Lee and Gerald before Gerald's diet improvement. Let's call this difference 't'. So, t = Lee's time - Gerald's initial time, which equals 38 seconds (Lee's time) - unspecified time 2. We are given that Lee was initially faster than Gerald by 2 seconds in the hurdles, meaning Lee had a time advantage of 2 seconds. Thus, t = 2 seconds.
        3. Now we know the time difference between them 4. Gerald's initial speed is not specified, but after his diet improvement, he became 10% faster. So, his new speed is 10% more than his previous speed.
        5. To find out how fast Gerald can run now, we need to calculate the time difference between Lee and Gerald with this new speed. Let's call this difference 't2'. So, t2 = Lee's time - Gerald's new time.
        6. We know that Lee still runs in 3",Node93,4,7,12,19,0.07472668476690936,114,False
" 1. First, we need to determine the time difference between Lee and Gerald before Gerald's diet improvement. Let's call this difference 't'. So, t = Lee's time - Gerald's initial time, which equals 38 seconds (Lee's time) - unspecified time 2. We are given that Lee was initially faster than Gerald by 2 seconds in the hurdles, meaning Lee had a time advantage of 2 seconds. Thus, t = 2 seconds.
        3. Now we know the time difference between them 4. Next, we have information about Gerald's improved speed due to his diet change, which is an increase by 10%. Let's call this 'g' (for the improvement rate).
        5. This new speed change means that Gerald can potentially",Node94,4,7,12,19,0.888087239341252,57,False
" 1. First, we need to determine the time difference between Lee and Gerald before Gerald's diet improvement. Let's call this difference 't'. So, t = Lee's time - Gerald's initial time, which equals 38 seconds (Lee's time) - unspecified time 2. We are given that Lee was initially faster than Gerald by 2 seconds in the hurdles, meaning Lee had a time advantage of 2 seconds. Thus, t = 2 seconds.
        3. Now we know the time difference between them 4. Since Gerald's speed has increased by 10%, it means he is running the distance more efficiently with his new diet. This implies that we need to compare their new speeds based on their previous times and this increase in efficiency. Let 'd' represent Gerald's improvement percentage,",Node95,4,7,12,19,0.8351004951226343,62,False
" 1. First, let's understand the initial situation: Lee runs 400-meter hurdles two seconds faster than Gerald. So, if Gerald runs it in X seconds, Lee would run it in (X - 2) seconds.
        2. Now, Gerald has improved his speed by 10% due to a change in diet. We need to find out how much faster he can run now compared to before the improvement 3. To calculate this, we'll multiply his initial speed (X seconds) by the percentage increase (10%) and then add it to X: (X * 0.10) + X = 0.1X + X
        4. Now, let's rewrite the equation with only one variable for Gerald's improved time: Y = 0.1X + X
        5. We 6. We also know that Lee runs in 38 seconds, which means 38 - 2 = (Y - 2) seconds for Gerald due to his diet change. So we can substitute these values into our equation: 36 = 0.1X + X - 2
        7. Now, solve for X (Gerald's time with improved speed): Subtract 0.1X from both sides 8. Get X alone on one side: 0.9X = 34
        9. Divide by 0.9 to get the value of X: X = 37.78
        Gerald can run the 400-meter hurdles at an improved speed of approximately 37.78 seconds, given his changed diet.",Node101,2,1,11,12,0.8298805472110181,93,False
" 1. First, let's understand the initial situation: Lee runs 400-meter hurdles two seconds faster than Gerald. So, if Gerald runs it in X seconds, Lee would run it in (X - 2) seconds.
        2. Now, Gerald has improved his speed by 10% due to a change in diet. We need to find out how much faster he can run now compared to before the improvement 3. To calculate this, we'll multiply his initial speed (X seconds) by the percentage increase (10%) and then add it to X: (X * 0.10) + X = 0.1X + X
        4. Now, let's rewrite the equation with only one variable for Gerald's improved time: Y = 0.1X + X
        5. We 6. We also know that Lee runs in 38 seconds, which means 38 - 2 = (Y - 2) seconds for Gerald due to his diet change. So we can substitute these values into our equation: 36 = 0.1X + X - 2
        7. Now, solve for X (Gerald's time with improved speed): Subtract 0.1X from both sides 8. Rearrange the equation to make it easier to solve: 0.9X = 34
        9. Divide both sides by 0.9
        X = 37.8 (rounded to two decimal places)
        10. Therefore,",Node102,2,1,11,12,0.7376590188868506,60,False
" 1. First, let's understand the initial situation: Lee runs 400-meter hurdles two seconds faster than Gerald. So, if Gerald runs it in X seconds, Lee would run it in (X - 2) seconds.
        2. Now, Gerald has improved his speed by 10% due to a change in diet. We need to find out how much faster he can run now compared to before the improvement 3. To calculate this, we'll multiply his initial speed (X seconds) by the percentage increase (10%) and then add it to X: (X * 0.10) + X = 0.1X + X
        4. Now, let's rewrite the equation with only one variable for Gerald's improved time: Y = 0.1X + X
        5. We 6. We also know that Lee runs in 38 seconds, which means 38 - 2 = (Y - 2) seconds for Gerald due to his diet change. So we can substitute these values into our equation: 36 = 0.1X + X - 2
        7. Now, solve for X (Gerald's time with improved speed): Subtract 0.1X from both sides 8. Simplify the equation: 0.9X = 34
        9. Divide by 0.9 to find X: X = 34 / 0.9
        X = 37.778
        10. Rounding it for simplicity, Gerald can run the 400-meter hurdles at an improved speed of approximately 38 seconds (rounded from his exact time) with his new diet.",Node103,0,1,9,10,0.816799597291147,108,False
" 1. First, let's understand the initial situation: Lee runs 400-meter hurdles two seconds faster than Gerald. So, if Gerald runs it in X seconds, Lee would run it in (X - 2) seconds.
        2. Now, Gerald has improved his speed by 10% due to a change in diet. We need to find out how much faster he can run now compared to before the improvement 3. To calculate this, we'll multiply his initial speed (X seconds) by the percentage increase (10%) and then add it to X: (X * 0.10) + X = 0.1X + X
        4. Now, let's rewrite the equation with only one variable for Gerald's improved time: Y = 0.1X + X
        5. We 6. know that Lee runs the 400-meter hurdles in 38 seconds. So, we can substitute this value into our equation to find out how fast Gerald can run with his improved diet: 38 = 0.1X + X
        7. 8. Now, let's solve for the unknown variable X by moving all X terms on one side of the equation and constants on the other side: 38 - X = 0.1X
        9. Next, we",Node126,3,6,12,18,0.568701168192506,49,0
" 1. First, let's understand the initial situation: Lee runs 400-meter hurdles two seconds faster than Gerald. So, if Gerald runs it in X seconds, Lee would run it in (X - 2) seconds.
        2. Now, Gerald has improved his speed by 10% due to a change in diet. We need to find out how much faster he can run now compared to before the improvement 3. To calculate this, we'll multiply his initial speed (X seconds) by the percentage increase (10%) and then add it to X: (X * 0.10) + X = 0.1X + X
        4. Now, let's rewrite the equation with only one variable for Gerald's improved time: Y = 0.1X + X
        5. We 6. know that Lee runs the 400-meter hurdles in 38 seconds. So, we can substitute this value into our equation to find out how fast Gerald can run with his improved diet: 38 = 0.1X + X
        7. 8. Now, let's solve for X by subtracting X from both sides of the equation: 38 - X = 0.1X
        9. Next, we'll move all terms containing X to one side and constants to the other side: 38 - 38 + X = 0.1X
        10. This simplifies to X = 0",Node127,5,10,14,24,0.021517566910127628,85,0
" 1. First, let's understand the initial situation: Lee runs 400-meter hurdles two seconds faster than Gerald. So, if Gerald runs it in X seconds, Lee would run it in (X - 2) seconds.
        2. Now, Gerald has improved his speed by 10% due to a change in diet. We need to find out how much faster he can run now compared to before the improvement 3. To calculate this, we'll multiply his initial speed (X seconds) by the percentage increase (10%) and then add it to X: (X * 0.10) + X = 0.1X + X
        4. Now, let's rewrite the equation with only one variable for Gerald's improved time: Y = 0.1X + X
        5. We 6. know that Lee runs the 400-meter hurdles in 38 seconds. So, we can substitute this value into our equation to find out how fast Gerald can run with his improved diet: 38 = 0.1X + X
        7. 8. Now, let's solve for X by moving all the X terms to one side and then isolating X: 28 = X (since 38 - 10 =",Node128,3,9,12,21,0.12886957409902677,40,0
" 1. First, let's understand the initial situation: Lee runs 400-meter hurdles two seconds faster than Gerald. So, if Gerald runs it in X seconds, Lee would run it in (X - 2) seconds.
        2. Now, Gerald has improved his speed by 10% due to a change in diet. We need to find out how much faster he can run now compared to before the improvement 3. To calculate this, we'll multiply his initial speed (X seconds) by the percentage increase (10%) and then add it to X: (X * 0.10) + X = 0.1X + X
        4. Now, let's rewrite the equation with only one variable for Gerald's improved time: Y = 0.1X + X
        5. We 6. know that Lee runs the 400-meter hurdles in 38 seconds. So, we can substitute this value into our equation to find out how fast Gerald can run with his improved diet: 38 = 0.1X + X
        7. 8. Now, let's solve for X (Gerald's time): Subtract X from both sides of the equation: 38 - X = 0.1X
         9. Divide by 0.1",Node129,3,8,12,20,0.18090285848308274,50,0
" 1. First, let's understand the initial situation: Lee runs 400-meter hurdles two seconds faster than Gerald. So, if Gerald runs it in X seconds, Lee would run it in (X - 2) seconds.
        2. Now, Gerald has improved his speed by 10% due to a change in diet. We need to find out how much faster he can run now compared to before the improvement 3. To calculate this, we'll multiply his initial speed (X seconds) by the percentage increase (10%) and then add it to X: (X * 0.10) + X = 0.1X + X
        4. Now, let's rewrite the equation with only one variable for Gerald's improved time: Y = 0.1X + X
        5. We 6. know that Lee runs the 400-meter hurdles in 38 seconds. So, we can substitute this value into our equation to find out how fast Gerald can run with his improved diet: 38 = 0.1X + X
        7. 8. Now, let's solve the equation for X (Gerald's improved time): 
          - Subtract X from both sides of the equation to eliminate the repeated variable: 38 - X = 0.1X",Node130,3,7,12,19,0.7721671635196327,53,0
" 1. First, let's understand the initial situation: Lee runs 400-meter hurdles two seconds faster than Gerald. So, if Gerald runs it in X seconds, Lee would run it in (X - 2) seconds.
        2. Now, Gerald has improved his speed by 10% due to a change in diet. We need to find out how much faster he can run now compared to before the improvement 3. To calculate this, we'll multiply his initial speed (X seconds) by the percentage increase (10%) and then add it to X: (X * 0.10) + X = 0.1X + X
        4. Now, let's rewrite the equation with only one variable for Gerald's improved time: Y = 0.1X + X
        5. We 6. know that Lee runs the 400-meter hurdles in 38 seconds. So, we can substitute this value into our equation to find out how fast Gerald can run with his improved diet: 38 = 0.1X + X
        7. 8. Now, let's solve the equation for X (Gerald's time): subtract X from both sides of the equation to isolate it on one side, then divide by 0.9 on both sides to remove",Node131,3,5,12,17,0.630184462052907,49,0
" 1. First, we need to determine the time difference between Lee and Gerald before Gerald's diet improvement. Let's call this difference 't'. So, t = Lee's time - Gerald's initial time, which equals 38 seconds (Lee's time) - unspecified time 2. We know that Lee used to be able to run the 400-meter hurdles two seconds faster than Gerald initially. So, t = 2 seconds.
        3. Now, we need to find out how much faster Gerald can run after his diet improvement. Let's call this difference 'f'. So, f = (10% of Gerald's initial time) 4. We know that Gerald's initial time is t - 2 seconds, which equals 38 seconds - 2 seconds = 36 seconds.
        5. To find the new improved time for Gerald after his diet change, we need to add this speed improvement (f) to his initial time: New_Gerald's_time = Initial_Gerald's_time",Node134,3,5,12,17,0.07176728890020168,86,False
" 1. First, let's analyze the given information about Lee and Gerald's performances before Gerald changed his diet. We know that Lee could run the 400-meter hurdles 2 seconds faster than Gerald. 2. Now, we need to consider Gerald's improved speed after changing his diet. His speed increased by 10%.
        3. To find out how fast Gerald can run with his new speed, let's first calculate the difference between Lee and Gerald's initial speeds. Since Lee was faster than Gerald by 2 seconds, we can say that Gerald initially ran at a speed of (Lee's speed - 2) seconds per 400-meter hurdles.
        4",Node140,1,7,8,15,0.09316154838966328,112,False
" 1. First, let's analyze the given information about Lee and Gerald's performances before Gerald changed his diet. We know that Lee could run the 400-meter hurdles 2 seconds faster than Gerald. 2. Now, we need to consider Gerald's improved speed after changing his diet. His new speed has increased by 10%.
        3. To find out how fast Lee runs the 400-meter hurdles now (in 38 seconds), we can convert his time into meters per",Node141,2,8,9,17,0.4765135744741755,67,False
" 1. First, let's analyze the given information about Lee and Gerald's performances before Gerald changed his diet. We know that Lee could run the 400-meter hurdles 2 seconds faster than Gerald. 2. Now, we need to consider Gerald's improvement in speed due to his new diet. His speed increased by 10%.
        3. To find out how much time Gerald would save with this",Node142,2,8,9,17,0.2315638871553719,45,False
" 1. First, let's analyze the given information about Lee and Gerald's performances before Gerald changed his diet. We know that Lee could run the 400-meter hurdles 2 seconds faster than Gerald. 2. Now, we have to consider Gerald's improved speed due to his new diet. His speed increased by 10%.
        3. To find out how fast Gerald can run with his improved speed, let's first calculate the time difference between Lee and Gerald before Gerald changed his diet. Since Lee was running 2 seconds faster than Gerald, we can say that Gerald took 2 seconds more to complete the race than Lee.
        4. Now, let's apply Gerald's improved speed of 10% to this time",Node143,1,7,8,15,0.1442330865753363,120,False
" 1. First, let's analyze the given information about Lee and Gerald's performances before Gerald changed his diet. We know that Lee could run the 400-meter hurdles 2 seconds faster than Gerald. 2. Now, we are given information about Gerald's improved speed after changing his diet. His speed increased by 10%.
        3. We need to determine how fast Gerald can run the 400-meter hurdles with his new speed.
        4. Let's denote Lee's initial time as L and Gerald's initial time as G. Since Lee is 2 seconds faster than Gerald, we have L = G",Node144,1,9,8,17,0.42575601014505693,99,False
" 1. First, let's analyze the given information about Lee and Gerald's performances before Gerald changed his diet. We know that Lee could run the 400-meter hurdles 2 seconds faster than Gerald. 2. Now, we are given a new fact: Gerald improved his speed by 10% after changing his diet. This means he can now run the 400-meter hurdles 10% faster than before.
        3. We know that Lee runs the 400-meter hurdles in 38 seconds,",Node146,1,7,8,15,0.34239621812249643,77,False
" 1. First, let's analyze the given information about Lee and Gerald's performances before Gerald changed his diet. We know that Lee could run the 400-meter hurdles 2 seconds faster than Gerald. 2. Now, we need to consider Gerald's improved speed after changing his diet. His speed increased by 10%.
        3. To find out how fast Gerald can run with his new speed, let's first calculate the difference between Lee and Gerald's initial speeds. Since Lee was faster than Gerald by 2 seconds, we can say that Gerald initially ran at a speed of (Lee's speed - 2) seconds per 400-meter hurdles.
        4 5. Now let's calculate the new speed for Gerald after improving it by 10%. To do this, we need to find 10% of his initial speed and then add that amount to his previous speed. So, his new speed is (Gerald's initial speed + 10% of his",Node147,6,9,14,23,0.34355747843001594,68,False
" 1. First, let's analyze the given information about Lee and Gerald's performances before Gerald changed his diet. We know that Lee could run the 400-meter hurdles 2 seconds faster than Gerald. 2. Now, we need to consider Gerald's improved speed after changing his diet. His speed increased by 10%.
        3. To find out how fast Gerald can run with his new speed, let's first calculate the difference between Lee and Gerald's initial speeds. Since Lee was faster than Gerald by 2 seconds, we can say that Gerald initially ran at a speed of (Lee's speed - 2) seconds per 400-meter hurdles.
        4 5. Next, we need to calculate the new speed of Gerald after his diet change. His initial speed was multiplied by 1.1 (10% increase), so Gerald's improved speed is: (Lee's speed - 2) * 1.1 seconds per",Node148,4,6,12,18,0.49577800400372074,63,False
" 1. First, let's analyze the given information about Lee and Gerald's performances before Gerald changed his diet. We know that Lee could run the 400-meter hurdles 2 seconds faster than Gerald. 2. Now, we need to consider Gerald's improved speed after changing his diet. His speed increased by 10%.
        3. To find out how fast Gerald can run with his new speed, let's first calculate the difference between Lee and Gerald's initial speeds. Since Lee was faster than Gerald by 2 seconds, we can say that Gerald initially ran at a speed of (Lee's speed - 2) seconds per 400-meter hurdles.
        4 4. Now, let's find out how fast Gerald ran after his diet change. We know that his improved speed is now 10% faster than before. To calculate this new speed, we can multiply his initial speed by",Node149,5,7,13,20,0.7446605472322309,49,False
" 1. First, let's analyze the given information about Lee and Gerald's performances before Gerald changed his diet. We know that Lee could run the 400-meter hurdles 2 seconds faster than Gerald. 2. Now, we need to consider Gerald's improved speed after changing his diet. His speed increased by 10%.
        3. To find out how fast Gerald can run with his new speed, let's first calculate the difference between Lee and Gerald's initial speeds. Since Lee was faster than Gerald by 2 seconds, we can say that Gerald initially ran at a speed of (Lee's speed - 2) seconds per 400-meter hurdles.
        4 5. Now, let's calculate the new speed for Gerald after his diet change. His improved speed is 10% faster than his initial speed. To find this new speed, we need to add 10% of his initial speed (which is equal to 0.1 * (Lee's speed - 2)) to his initial speed. So Gerald's new speed = (Gerald's initial speed) + (0.1 * (Lee's speed - 2)).
        6. Pl",Node152,4,6,12,18,0.33324409091471197,114,False
" 1. First, let's analyze the given information about Lee and Gerald's performances before Gerald changed his diet. We know that Lee could run the 400-meter hurdles 2 seconds faster than Gerald. 2. Now, we are given a new fact: Gerald improved his speed by 10% after changing his diet. This means he can now run the 400-meter hurdles 10% faster than before.
        3. We know that Lee runs the 400-meter hurdles in 38 seconds, 4. Our goal is to find out how fast Gerald, with his improved diet, can run the same race in seconds. To do this, we have to account for both their relative speed differences and the fact that they are running the same distance (40",Node161,6,9,14,23,0.8571484408783605,53,False
" 1. First, let's analyze the given information about Lee and Gerald's performances before Gerald changed his diet. We know that Lee could run the 400-meter hurdles 2 seconds faster than Gerald. 2. Now, we are given a new fact: Gerald improved his speed by 10% after changing his diet. This means he can now run the 400-meter hurdles 10% faster than before.
        3. We know that Lee runs the 400-meter hurdles in 38 seconds, 4. To find out how fast Gerald can run with his improved speed, we need to consider the initial difference between their speeds and the new improvement in Gerald's speed.
        5. Let's denote Lee's initial speed as L_initial and Gerald's initial speed as G_initial. We know that L_initial = G_initial - 2 seconds.
        6. After Gerald improved his speed by 10%, we can represent this new speed as G_improved = (G_initial + 0.1 * G",Node162,5,5,13,18,0.11450161347623322,120,False
" 1. First, let's analyze the given information about Lee and Gerald's performances before Gerald changed his diet. We know that Lee could run the 400-meter hurdles 2 seconds faster than Gerald. 2. Now, we are given a new fact: Gerald improved his speed by 10% after changing his diet. This means he can now run the 400-meter hurdles 10% faster than before.
        3. We know that Lee runs the 400-meter hurdles in 38 seconds, 4. Since Gerald's current speed is still not as fast as Lee's initial speed, we need to consider both their improvements and their starting speeds. To do this, let's first find out how much faster Lee was",Node163,7,10,15,25,0.5333053033816173,48,False
" 1. First, let's analyze the given information about Lee and Gerald's performances before Gerald changed his diet. We know that Lee could run the 400-meter hurdles 2 seconds faster than Gerald. 2. Now, we are given a new fact: Gerald improved his speed by 10% after changing his diet. This means he can now run the 400-meter hurdles 10% faster than before.
        3. We know that Lee runs the 400-meter hurdles in 38 seconds, 4. To find out how fast Gerald can run with his improved speed, we need to consider the difference between their speeds. Initially, Lee ran 2 seconds faster than Gerald. With Gerald's newfound speed improvement of 10%, we need to determine how much faster he is now in comparison to Lee.
        5. To do this, let's convert the speed differences into fractions:",Node164,5,8,13,21,0.6382639915249048,88,False
" 1. First, let's analyze the given information about Lee and Gerald's performances before Gerald changed his diet. We know that Lee could run the 400-meter hurdles 2 seconds faster than Gerald. 2. Now, we are given a new fact: Gerald improved his speed by 10% after changing his diet. This means he can now run the 400-meter hurdles 10% faster than before.
        3. We know that Lee runs the 400-meter hurdles in 38 seconds, 4. To find Gerald's improved time, we need to subtract his original time difference from Lee's new time and then account for the speed increase after changing his diet. First, let's subtract Lee's initial advantage of 2 seconds: 38 - 2 = 36 seconds.
        5. Now let's add Gerald's improved speed of 10% to his original time difference with Lee (the 2-second",Node165,4,6,12,18,0.9088970759134273,100,False
" 1. First, let's analyze the given information about Lee and Gerald's performances before Gerald changed his diet. We know that Lee could run the 400-meter hurdles 2 seconds faster than Gerald. 2. Now, we are given a new fact: Gerald improved his speed by 10% after changing his diet. This means he can now run the 400-meter hurdles 10% faster than before.
        3. We know that Lee runs the 400-meter hurdles in 38 seconds, 4. To find Gerald's time with his improved speed, let's consider the relationship between their speeds: Gerald's new speed is 10% faster than his old one, which was 2 seconds slower than Lee's. Since we know that Lee can run the race in 38 seconds, we can break it down into 36 seconds (the",Node166,3,7,11,18,0.6180112530491813,79,False
" 1. First, let's analyze the given information about Lee and Gerald's performances before Gerald changed his diet. We know that Lee could run the 400-meter hurdles 2 seconds faster than Gerald. 2. Now, we are given a new fact: Gerald improved his speed by 10% after changing his diet. This means he can now run the 400-meter hurdles 10% faster than before.
        3. We know that Lee runs the 400-meter hurdles in 38 seconds, 4. To find out how fast Gerald can run with his improved diet, we need to consider the difference between their new speeds and account for the initial speed advantage Lee had over Gerald. So let's calculate Lee's new speed (after accounting for the 2-second advantage): 38 seconds - 2 seconds = 36 seconds.
        5. Now, we can find out how much faster Gerald is running with his improved diet by comparing this new time to Lee's",Node167,2,6,10,16,0.3608449252574891,104,False
" 1. First, let's understand the initial situation: Lee runs 400-meter hurdles two seconds faster than Gerald. So, if Gerald runs it in X seconds, Lee would run it in (X - 2) seconds.
        2. Now, Gerald has improved his speed by 10% due to a change in diet. We need to find out how much faster he can run now compared to before the improvement 3. To calculate this, we'll multiply his initial speed (X seconds) by the percentage increase (10%) and then add it to X: (X * 0.10) + X = 0.1X + X
        4. Now, let's rewrite the equation with only one variable for Gerald's improved time: Y = 0.1X + X
        5. We 6. know that Lee runs the 400-meter hurdles in 38 seconds. So, we can substitute this value into our equation to find out how fast Gerald can run with his improved diet: 38 = 0.1X + X
        7. 8. Now, let's solve the equation for X (Gerald's time): subtract X from both sides of the equation to isolate it on one side, then divide by 0.9 on both sides to remove 9. the decimal part: 38 - X = 0.1X
        X = 27
        Gerald can run the 400-meter hurdles in 27 seconds with his improved diet.",Node184,5,0,17,17,0.08880418358963138,115,False
