continuation,Node Path,V Score,H Score,G Score,F Score,Temperature,Max Tokens,Wrong Solution Flag
" 1. First, let's determine the total square footage for all levels combined. Since each level has half the area of the one below it, we can use this relationship to find the square footage of other levels.
   2. The top level has a square footage of 16. To find the square footage of the",Node0,5,9,5,14,0.24230210558062382,67,False
" 1. First, let's find out how many times each level's area is reduced compared to the one below it. We know that each level will have half the square footage as the level below it.

2. Let's denote the square footage of the first level as 'A'. Since the second level has half",Node1,5,9,5,14,0.4477229544949678,68,False
" 1. First, let's identify the question we are trying to answer: The average square footage of a level in a 4-leveled sandcastle where each level has half the area compared to the level below it with the topmost level having an area of 16 sq ft.

2. Next, understand that Luke builds the castle going from the bottom up; therefore, the levels have progress",Node2,6,9,6,15,0.8873267311004894,84,False
" 1. First, let's determine the total square footage of all levels combined. Since each level has half the area of the one below it, we can use this relationship to find the square footage for each level.
   2. The top level has a square footage of 16. We know that the next level will have half the size, so its square footage is 16 / 2 = 8.
   3. Continue this process for all levels:
       -",Node4,3,8,3,11,0.026828106294890297,102,False
" 1. First, let's understand the relationship between levels and their respective square footages. Each level will have half the area of the one below it. This means that for every level, the square footage decreases by 50% in comparison to the previous level.
        2. Now, we know that Luke has built a 4-leveled sandcastle with the top level having a square footage of 16. We need to find",Node5,4,9,4,13,0.3916081343105766,93,False
" 1. We know that the top level has a square footage of 16.
        2. Each level's square footage will be half of the one below it.
        3. To find the total square footage for all levels, we need to add up the square footage of each level from",Node6,6,9,6,15,0.1455117491280108,62,False
" 1. First, let's determine the total square footage of all levels combined. Since each level has half the area of the one below it, we can use this relationship to find the square footage for each level.
   2. The top level has a square footage of 16. We know that the next level will have half the size, so its square footage is 16 / 2 = 8.
   3. Continue this process for all levels:
       - Level 2: 8 / 2 = 4
         Level 3: 4 / 2 = 2
         Level 4 (bottom): 2 / 2 = 1
   4. Now, add up",Node7,1,8,4,12,0.3987618712611166,50,False
" 1. First, let's determine the total square footage of all levels combined. Since each level has half the area of the one below it, we can use this relationship to find the square footage for each level.
   2. The top level has a square footage of 16. We know that the next level will have half the size, so its square footage is 16 / 2 = 8.
   3. Continue this process for all levels:
       - Level 1: 8 (half of 16)
         Level 2: 4 (half of 8)
         Level 3: 2 (half of 4)
         Level 4: 1 (half of 2)
   4. Now, add up the square footage for all levels to find the total area: 16 +",Node8,1,8,4,12,0.513397639377254,80,False
" 1. First, let's determine the total square footage of all levels combined. Since each level has half the area of the one below it, we can use this relationship to find the square footage for each level.
   2. The top level has a square footage of 16. We know that the next level will have half the size, so its square footage is 16 / 2 = 8.
   3. Continue this process for all levels:
       - Level 2: 8 / 2 = 4
         Level 3: 4 / 2 = 2
         Level 4: 2 / 2 = 1
   4. Now, add up the square footage of each level to find the total area for all levels combined: 16 + 8 +",Node9,1,8,4,12,0.28042899394238996,71,False
" 1. First, let's determine the total square footage of all levels combined. Since each level has half the area of the one below it, we can use this relationship to find the square footage for each level.
   2. The top level has a square footage of 16. We know that the next level will have half the size, so its square footage is 16 / 2 = 8.
   3. Continue this process for all levels:
       - Level 2: 8 / 2 = 4
         Level 3: 4 / 2 = 2
         Level 4: 2 / 2 = 1
   4. Now, add up the square footage of each level to find the total area: 16 + 8 + 4 + 2 + 1",Node10,5,8,8,16,0.26646385983533094,75,False
" 1. First, let's determine the total square footage of all levels combined. Since each level has half the area of the one below it, we can use this relationship to find the square footage for each level.
   2. The top level has a square footage of 16. We know that the next level will have half the size, so its square footage is 16 / 2 = 8.
   3. Continue this process for all levels:
       - Level 1 (top) = 16
         Level 2 = 8
         Level 3 = 4
         Level 4 = 2
   4. Now, add the square footage of all levels together to find the total",Node12,2,8,5,13,0.2837581036489346,52,False
" 1. First, let's determine the total square footage of all levels combined. Since each level has half the area of the one below it, we can use this relationship to find the square footage for each level.
   2. The top level has a square footage of 16. We know that the next level will have half the size, so its square footage is 16 / 2 = 8.
   3. Continue this process for all levels:
       - Level 2: Square footage is 8 / 2 = 4
         Level 3: Square footage is 4 / 2 = 2
         Level 4 (bottom level): Square footage is 2 / 2 = 1
   4. Now, we have the square footage for each level. To find the average square footage of a level, we can add all levels' square footages together",Node13,1,5,4,9,0.6201802490955138,87,False
" 1. First, let's determine the total square footage of all levels combined. Since each level has half the area of the one below it, we can use this relationship to find the square footage for each level.
   2. The top level has a square footage of 16. We know that the next level will have half the size, so its square footage is 16 / 2 = 8.
   3. Continue this process for all levels:
       - Level 2: 8 / 2 = 4
         Level 3: 4 / 2 = 2
         Level 4: 2 / 2 = 1
   4. Now, add up the square footage of each level to find the total area for all levels combined: 16 + 8 + 4 + 2 + 1 = 31
   5. Finally, calculate the average by dividing the total square footage by the number of levels (which is 4 in this case):
       Average = Total Area / Number of Levels = 31 / 4 = 7.75

So the average square footage for each level is approximately 7.75.",Node35,1,1,5,6,0.9107637085072128,87,False
" 1. First, let's determine the total square footage of all levels combined. Since each level has half the area of the one below it, we can use this relationship to find the square footage for each level.
   2. The top level has a square footage of 16. We know that the next level will have half the size, so its square footage is 16 / 2 = 8.
   3. Continue this process for all levels:
       - Level 2: 8 / 2 = 4
         Level 3: 4 / 2 = 2
         Level 4: 2 / 2 = 1
   4. Now, add up the square footage of each level to find the total area for all levels combined: 16 + 8 + 4 + 2 + 1 = 31
   5. Finally, divide the total area by the number of levels (which is 4) to get the average square footage per level:",Node36,1,1,5,6,0.04803109613924261,42,False
" 1. First, let's determine the total square footage of all levels combined. Since each level has half the area of the one below it, we can use this relationship to find the square footage for each level.
   2. The top level has a square footage of 16. We know that the next level will have half the size, so its square footage is 16 / 2 = 8.
   3. Continue this process for all levels:
       - Level 2: 8 / 2 = 4
         Level 3: 4 / 2 = 2
         Level 4: 2 / 2 = 1
   4. Now, add up the square footage of each level to find the total area for all levels combined: 16 + 8 + 4 + 2 + 1 = 31 (these are the values from top to bottom).
   5. To find the average square footage for a single level, we need to divide the total square footage by the number of levels: 31 / 4 = 7.75.
   6. Therefore, the average square footage of a level in Luke's sandcastle is approximately 7.75.",Node37,1,1,5,6,0.47087738627509135,99,False
" 1. First, let's determine the total square footage of all levels combined. Since each level has half the area of the one below it, we can use this relationship to find the square footage for each level.
   2. The top level has a square footage of 16. We know that the next level will have half the size, so its square footage is 16 / 2 = 8.
   3. Continue this process for all levels:
       - Level 2: 8 / 2 = 4
         Level 3: 4 / 2 = 2
         Level 4: 2 / 2 = 1
   4. Now, add up the square footage of each level to find the total area for all levels combined: 16 + 8 + 4 + 2 + 1 = 31
   5. To get the average square footage per level, simply divide the total square footage by the number of levels (which is 4): 31 / 4 = 7.75

So, on average each level has a square footage of 7.75.",Node39,1,1,5,6,0.9071619289690637,103,False
" 1. First, let's determine the total square footage of all levels combined. Since each level has half the area of the one below it, we can use this relationship to find the square footage for each level.
   2. The top level has a square footage of 16. We know that the next level will have half the size, so its square footage is 16 / 2 = 8.
   3. Continue this process for all levels:
       - Level 2: 8 / 2 = 4
         Level 3: 4 / 2 = 2
         Level 4: 2 / 2 = 1
   4. Now, add up the square footage of each level to find the total area for all levels combined: 16 + 8 + 4 + 2 + 1 = 31
   5. Finally, divide the total area by the number of levels (which is 4) to find the average square footage per level: 31 / 4 = 7.75
   6. The average square footage of a level in Luke's sandcastle is approximately 7.75.",Node40,1,1,5,6,0.33296848563791637,99,False
" 1. First, let's understand the relationship between levels and their respective square footages. Each level will have half the area of the one below it. This means that for every level, the square footage decreases by 50% in comparison to the previous level.
        2. Now, we know that Luke has built a 4-leveled sandcastle with the top level having a square footage of 16. We need to find 3. To calculate the average square footage, we'll add up all levels' square footages and then divide them by the total number of levels (which is 4 in this case).

           So, the equation to calculate the average will be: (square footage of level",Node77,2,7,6,13,0.9847015011100849,59,False
" 1. First, let's understand the relationship between levels and their respective square footages. Each level will have half the area of the one below it. This means that for every level, the square footage decreases by 50% in comparison to the previous level.
        2. Now, we know that Luke has built a 4-leveled sandcastle with the top level having a square footage of 16. We need to find 3. The average square footage for each level. To do this, we'll take the total square footage and divide it by the number of levels (4 in this case).
        4. Total square footage = Sum of the square footages of all levels. Since it decreases by 50% with each step, we can write this as a geometric series: 16 + 8 + 4 + 2 = 30 units of square footage
         5. Now, to find the average, we'll",Node78,1,2,5,7,0.8528087346776232,110,False
" 1. First, let's understand the relationship between levels and their respective square footages. Each level will have half the area of the one below it. This means that for every level, the square footage decreases by 50% in comparison to the previous level.
        2. Now, we know that Luke has built a 4-leveled sandcastle with the top level having a square footage of 16. We need to find 3. To calculate the average square footage per level, we'll first determine the total square footage for all levels and then divide it by the number of levels (4).
        Total square footage = Square footage of level 1 + Square footage of level 2 + Square footage of level 3 + Square footage of level 4
        4. Level 1 has half the square footage of level 2, which is",Node79,2,5,6,11,0.24624693078934057,88,False
" 1. First, let's understand the relationship between levels and their respective square footages. Each level will have half the area of the one below it. This means that for every level, the square footage decreases by 50% in comparison to the previous level.
        2. Now, we know that Luke has built a 4-leveled sandcastle with the top level having a square footage of 16. We need to find 3. The average square footage for each level. To do this, we can calculate the total square footage and then divide it by the number of levels (which is 4 in this case).
        4. Let's start with the top level having a square footage of 16. We know that every level has half the area of the one below it. So, for the second level, we can calculate its square footage as 16 /",Node80,2,6,6,12,0.0907615689403719,93,False
" 1. First, let's understand the relationship between levels and their respective square footages. Each level will have half the area of the one below it. This means that for every level, the square footage decreases by 50% in comparison to the previous level.
        2. Now, we know that Luke has built a 4-leveled sandcastle with the top level having a square footage of 16. We need to find 3. To calculate the average square footage per level, we will add up all the levels' square footages and then divide by the total number of levels (which is 4 in this case).
        4. Let's denote the square footage for each level as follows: Level 1 - x, Level 2 - x/2, Level 3 - x/4, Level 4 - x/8
        5. We know that Level 4 has a square footage of 16 and it is x",Node81,4,7,8,15,0.39133309042171505,108,False
" 1. First, let's understand the relationship between levels and their respective square footages. Each level will have half the area of the one below it. This means that for every level, the square footage decreases by 50% in comparison to the previous level.
        2. Now, we know that Luke has built a 4-leveled sandcastle with the top level having a square footage of 16. We need to find 3. The average square footage of a single level. To do this, we can add up all the levels' square footages and then divide it by the total number of levels (which is 4).
        4. To calculate each level's square footage, let's use the relationship from step 1 that every level has half the area of the one below it. We start with a base value for the first level which we assign as 16 (the top level's",Node82,3,8,7,15,0.5735859227012537,101,False
" 1. First, let's understand the relationship between levels and their respective square footages. Each level will have half the area of the one below it. This means that for every level, the square footage decreases by 50% in comparison to the previous level.
        2. Now, we know that Luke has built a 4-leveled sandcastle with the top level having a square footage of 16. We need to find 3. The average square footage for each level. To do this, we can calculate the total square footage of all levels and then divide it by the number of levels (which is 4).
        4. Let's start with the top level, which has a square footage of 16. We need to find the square footage",Node83,2,6,6,12,0.05004732533084255,69,False
" 1. First, let's understand the relationship between levels and their respective square footages. Each level will have half the area of the one below it. This means that for every level, the square footage decreases by 50% in comparison to the previous level.
        2. Now, we know that Luke has built a 4-leveled sandcastle with the top level having a square footage of 16. We need to find 3. The average square footage for each level. To do this, we'll take the total square footage and divide it by the number of levels (4 in this case).
        4. Total square footage = Sum of the square footages of all levels. Since it decreases by 50% with each step, we can write this as a geometric series: 16 + 8 + 4 + 2 = 30 units of square footage
         5. Now, to find the average, we'll 6. Calculate the average square footage per level by dividing the total square footage by the number of levels. Average square footage per level = Total square footage / Number of levels = 30 / 4 =",Node84,1,1,6,7,0.9140653776566332,44,False
" 1. First, let's understand the relationship between levels and their respective square footages. Each level will have half the area of the one below it. This means that for every level, the square footage decreases by 50% in comparison to the previous level.
        2. Now, we know that Luke has built a 4-leveled sandcastle with the top level having a square footage of 16. We need to find 3. The average square footage for each level. To do this, we'll take the total square footage and divide it by the number of levels (4 in this case).
        4. Total square footage = Sum of the square footages of all levels. Since it decreases by 50% with each step, we can write this as a geometric series: 16 + 8 + 4 + 2 = 30 units of square footage
         5. Now, to find the average, we'll divide the total square footage by the number of levels (which is 4): Average square footage per level = Total square footage / Number of levels
              Average square footage per level = 30 / 4 = 7.5 units
          6. Finally, Luke's average square footage per level for his 4-leveled sandcastle is approximately 7.5 units.",Node85,2,2,7,9,0.9029375259544666,101,False
" 1. First, let's understand the relationship between levels and their respective square footages. Each level will have half the area of the one below it. This means that for every level, the square footage decreases by 50% in comparison to the previous level.
        2. Now, we know that Luke has built a 4-leveled sandcastle with the top level having a square footage of 16. We need to find 3. The average square footage for each level. To do this, we'll take the total square footage and divide it by the number of levels (4 in this case).
        4. Total square footage = Sum of the square footages of all levels. Since it decreases by 50% with each step, we can write this as a geometric series: 16 + 8 + 4 + 2 = 30 units of square footage
         5. Now, to find the average, we'll divide the total square footage by the number of levels: Average square footage per level = Total square footage / Number of levels = 30 / 4 = 7.5 units of square footage
        So, the average square footage for each level in Luke's sandcastle is",Node86,0,1,5,6,0.2647697556274019,58,False
" 1. First, let's understand the relationship between levels and their respective square footages. Each level will have half the area of the one below it. This means that for every level, the square footage decreases by 50% in comparison to the previous level.
        2. Now, we know that Luke has built a 4-leveled sandcastle with the top level having a square footage of 16. We need to find 3. The average square footage for each level. To do this, we'll take the total square footage and divide it by the number of levels (4 in this case).
        4. Total square footage = Sum of the square footages of all levels. Since it decreases by 50% with each step, we can write this as a geometric series: 16 + 8 + 4 + 2 = 30 units of square footage
         5. Now, to find the average, we'll divide the total square footage by the number of levels: Average square footage per level = Total square footage / Number of levels = 30 / 4 = 7.5 units of square footage
        So, the average square footage of a level in Luke's sandcastle is approximately 7.5 units.",Node87,0,0,5,5,0.15908251452463706,66,False
