continuation,Node Path,V Score,H Score,G Score,F Score,Temperature,Max Tokens,Wrong Solution Flag
" 1. First, let's calculate the total cost of the cell phones without any interest. To do this, multiply the number of units (5) by the price per unit ($150). So, 5 * $150 = $750.
        2. Next, we need to find out how",Node1,2,7,2,9,0.06869778274772387,69,False
" 1. First, let's find the total cost of all the cell phones without the interest. To do this, multiply the number of units (5) by the price per unit ($150). So, 5 * $150 = $750.
        Now we have the initial amount Shiela will pay for the cell phones, which is $750.
        2. Next, let's calculate the interest she has to pay. To do this, multiply the total cost ($7",Node3,2,8,2,10,0.5168108705421991,111,False
" 1. First, we need to calculate the total cost of all 5 cell phones before considering any interest. We do this by multiplying the number of units (5) by their individual price ($150). This gives us 5 * $150 =",Node4,2,9,2,11,0.7435153474758865,55,False
" 1. First, let's calculate the total cost of the cell phones without any additional charges. The price per phone is $150 and she bought five phones, so the total cost is 5 * $150 = $750.
        2. Now, we need to consider the interest charged on each unit. A 2% interest will be added for each of the five cell phones. To calculate this, multiply the price per phone by the interest",Node6,3,7,3,10,0.346240262773292,99,False
" 1. First, let's calculate the total cost of the cell phones without any interest. To do this, multiply the number of units (5) by the price per unit ($150). So, 5 * $150 = $750.
        2. Next, we need to find out how 3. much interest Shiela will pay for each unit. To do this, multiply the number of units (5) by the interest rate (2%) as a decimal (0.02). So, 5 * 0.02 =",Node7,4,8,6,14,0.34182333740727744,53,False
" 1. First, let's calculate the total cost of the cell phones without any interest. To do this, multiply the number of units (5) by the price per unit ($150). So, 5 * $150 = $750.
        2. Next, we need to find out how 3. much interest will be charged on each cell phone. We'll use a 2% rate for this calculation. Multiply the price per unit ($150) by the interest rate (0.02). The result is $150 * 0.02 = $3.
        4. Now, let's find the total cost including interest. To do this, add the calculated interest amount from step 3 to the original cost from step 1 ($750",Node8,2,6,4,10,0.8849402561466666,105,False
" 1. First, let's calculate the total cost of the cell phones without any interest. To do this, multiply the number of units (5) by the price per unit ($150). So, 5 * $150 = $750.
        2. Next, we need to find out how 3. much interest Shiela will have to pay. She has 5 cell phones with a 2% interest rate. To calculate the total interest, multiply the number of units (5",Node9,5,8,7,15,0.7009134289125113,40,False
" 1. First, let's calculate the total cost of the cell phones without any interest. To do this, multiply the number of units (5) by the price per unit ($150). So, 5 * $150 = $750.
        2. Next, we need to find out how 3. much Shiela will pay in total with the interest. To do this, multiply the total cost without interest ($750) by the interest rate (2%). We'll convert 2% to",Node10,4,7,6,13,0.3729352555930674,46,False
" 1. First, let's calculate the total cost of the cell phones without any interest. To do this, multiply the number of units (5) by the price per unit ($150). So, 5 * $150 = $750.
        2. Next, we need to find out how 3. much interest Shiela will pay for each unit. To do this, multiply the price of one unit ($150) by the interest rate (2%). So, $150 * 0.02 = $3.
        4. Now, let's calculate the total interest she will pay. Multiply the number of units (5) by the interest per unit ($3). So, 5 * $3 = $15.",Node11,2,6,4,10,0.06238830288693631,102,False
" 1. First, let's calculate the total cost of the cell phones without any interest. To do this, multiply the number of units (5) by the price per unit ($150). So, 5 * $150 = $750.
        2. Next, we need to find out how 3. much interest Shiela will pay for each unit. To do this, multiply the price of one unit ($150) by the interest rate (2%). So, $150 * 0.02 = $3.
        4",Node13,2,6,4,10,0.015148156492707177,56,False
" 1. First, let's calculate the total cost of the cell phones without any additional charges. The price per phone is $150 and she bought five phones, so the total cost is 5 * $150 = $750.
        2. Now, we need to consider the interest charged on each unit. A 2% interest will be added for each of the five cell phones. To calculate this, multiply the price per phone by the interest rate: 5 * $150 * 0.02 = $30.
        3. Add the interest to the total cost of the cell phones: $750 + $30 = $780.
        4. Shiela will pay this amount over a period of 3 months",Node23,2,5,5,10,0.17483401821668,68,False
" 1. First, let's calculate the total cost of the cell phones without any additional charges. The price per phone is $150 and she bought five phones, so the total cost is 5 * $150 = $750.
        2. Now, we need to consider the interest charged on each unit. A 2% interest will be added for each of the five cell phones. To calculate this, multiply the price per phone by the interest rate: 5 * $150 * 0.02 = $30.
        3. Adding this extra cost to the initial total cost gives us the final total cost including the interest: $750 + $30 =",Node27,2,7,5,12,0.3571028507453742,53,False
" 1. First, let's calculate the total cost of the cell phones without any interest. To do this, multiply the number of units (5) by the price per unit ($150). So, 5 * $150 = $750.
        2. Next, we need to find out how 3. much interest will be charged on each cell phone. We'll use a 2% rate for this calculation. Multiply the price per unit ($150) by the interest rate (0.02). The result is $150 * 0.02 = $3.
        4. Now, let's find the total cost including interest. To do this, add the calculated interest amount from step 3 to the original cost from step 1 ($750 5. Finally, we need to divide the total cost by the number of months (3) to determine how much Shiela will pay each month. So, $850 / 3 = $283.33.
        Shiela will pay $283.33 each month for 3 months.",Node28,6,6,10,16,0.017079438223248977,118,False
" 1. First, let's calculate the total cost of the cell phones without any interest. To do this, multiply the number of units (5) by the price per unit ($150). So, 5 * $150 = $750.
        2. Next, we need to find out how 3. much interest will be charged on each cell phone. We'll use a 2% rate for this calculation. Multiply the price per unit ($150) by the interest rate (0.02). The result is $150 * 0.02 = $3.
        4. Now, let's find the total cost including interest. To do this, add the calculated interest amount from step 3 to the original cost from step 1 ($750 5. Finally, we need to divide the total cost by the number of months (3) to determine how much Shiela will pay each month. So, $850 / 3 = $283.33.
        Shiela will pay $283.33 each month for 3 months.",Node29,6,6,10,16,0.12892688130569419,80,False
" 1. First, let's calculate the total cost of the cell phones without any interest. To do this, multiply the number of units (5) by the price per unit ($150). So, 5 * $150 = $750.
        2. Next, we need to find out how 3. much interest will be charged on each cell phone. We'll use a 2% rate for this calculation. Multiply the price per unit ($150) by the interest rate (0.02). The result is $150 * 0.02 = $3.
        4. Now, let's find the total cost including interest. To do this, add the calculated interest amount from step 3 to the original cost from step 1 ($750 5. Finally, we need to divide the total cost by the number of months (3) to determine how much Shiela will pay each month for 3 months. So, $900 / 3 = $300 per month.
        Shiela will pay $300 each month",Node30,4,4,8,12,0.5253300847760292,65,False
" 1. First, let's calculate the total cost of the cell phones without any interest. To do this, multiply the number of units (5) by the price per unit ($150). So, 5 * $150 = $750.
        2. Next, we need to find out how 3. much interest will be charged on each cell phone. We'll use a 2% rate for this calculation. Multiply the price per unit ($150) by the interest rate (0.02). The result is $150 * 0.02 = $3.
        4. Now, let's find the total cost including interest. To do this, add the calculated interest amount from step 3 to the original cost from step 1 ($750 5. Finally, we need to divide the total cost by the number of months (3) to determine how much Shiela will pay each month. So, $850 / 3 = $283.33.
        Shiela will pay $283.33 each month for 3 months.",Node31,6,6,10,16,0.2991056793941931,119,False
" 1. First, let's calculate the total cost of the cell phones without any interest. To do this, multiply the number of units (5) by the price per unit ($150). So, 5 * $150 = $750.
        2. Next, we need to find out how 3. much interest will be charged on each cell phone. We'll use a 2% rate for this calculation. Multiply the price per unit ($150) by the interest rate (0.02). The result is $150 * 0.02 = $3.
        4. Now, let's find the total cost including interest. To do this, add the calculated interest amount from step 3 to the original cost from step 1 ($750 5. Finally, we'll divide the total cost by the number of months (3) to determine how much Shiela will pay each month. So, $900 / 3 = $300 per month.
        In conclusion, Shiela will pay $300 each month for 3 months in installments as part of her cell phone purchase.",Node32,4,4,8,12,0.4642992273407609,86,False
" 1. First, let's calculate the total cost of the cell phones without any interest. To do this, multiply the number of units (5) by the price per unit ($150). So, 5 * $150 = $750.
        2. Next, we need to find out how 3. much interest will be charged on each cell phone. We'll use a 2% rate for this calculation. Multiply the price per unit ($150) by the interest rate (0.02). The result is $150 * 0.02 = $3.
        4. Now, let's find the total cost including interest. To do this, add the calculated interest amount from step 3 to the original cost from step 1 ($750 5. Finally, we need to divide the total cost by the number of installments (3 months) to determine how much Shiela will pay each month. So, $850 / 3 = $283.33.
        Shiela will pay $283.33 each month for 3 months.",Node33,6,6,10,16,0.17490501962520177,117,False
" 1. First, let's calculate the total cost of the cell phones without any interest. To do this, multiply the number of units (5) by the price per unit ($150). So, 5 * $150 = $750.
        2. Next, we need to find out how 3. much interest will be charged on each cell phone. We'll use a 2% rate for this calculation. Multiply the price per unit ($150) by the interest rate (0.02). The result is $150 * 0.02 = $3.
        4. Now, let's find the total cost including interest. To do this, add the calculated interest amount from step 3 to the original cost from step 1 ($750 5. Finally, we need to divide the total cost by the number of months (3) to determine how much Shiela will pay each month. So, $850 / 3 = $283.33.
        Shiela will pay $283.",Node34,6,6,10,16,0.18670616606388546,61,False
" 1. First, let's calculate the total cost of the cell phones without any interest. To do this, multiply the number of units (5) by the price per unit ($150). So, 5 * $150 = $750.
        2. Next, we need to find out how 3. much interest Shiela will pay for each unit. To do this, multiply the price of one unit ($150) by the interest rate (2%). So, $150 * 0.02 = $3.
        4. Now, let's calculate the total interest she will pay. Multiply the number of units (5) by the interest per unit ($3). So, 5 * $3 = $15. 5. Finally, we need to add the total cost of cell phones without any interest ($750) with the total interest she will pay ($15). This gives us her overall cost which is $765.
        6. To divide this amount equally over 3 months, we'll need to find out how",Node35,1,2,5,7,0.8291798709816177,68,False
" 1. First, let's calculate the total cost of the cell phones without any interest. To do this, multiply the number of units (5) by the price per unit ($150). So, 5 * $150 = $750.
        2. Next, we need to find out how 3. much interest Shiela will pay for each unit. To do this, multiply the price of one unit ($150) by the interest rate (2%). So, $150 * 0.02 = $3.
        4. Now, let's calculate the total interest she will pay. Multiply the number of units (5) by the interest per unit ($3). So, 5 * $3 = $15. 5. Finally, we need to add the interest to the original cost to find the total cost including interest. Add $750 (initial price) to $15 (interest amount), giving us $765 as the new total cost with interest.
        6. We already know that Shiela will pay this amount over three months. To break down her payment, we simply divide the total cost ($",Node37,1,2,5,7,0.9773219718964952,86,False
" 1. First, let's calculate the total cost of the cell phones without any interest. To do this, multiply the number of units (5) by the price per unit ($150). So, 5 * $150 = $750.
        2. Next, we need to find out how 3. much interest Shiela will pay for each unit. To do this, multiply the price of one unit ($150) by the interest rate (2%). So, $150 * 0.02 = $3.
        4. Now, let's calculate the total interest she will pay. Multiply the number of units (5) by the interest per unit ($3). So, 5 * $3 = $15. 5. Finally, add the total cost without any interest and the interest to find out the total amount Shiela has to pay in 3 months. Total cost without interest is $750, and the total interest is $15. So, $750 + $15 = $765.
        6. To distribute this payment over 3 months, we'll divide it by the number of",Node38,1,2,5,7,0.8272328552686403,88,False
" 1. First, let's calculate the total cost of the cell phones without any interest. To do this, multiply the number of units (5) by the price per unit ($150). So, 5 * $150 = $750.
        2. Next, we need to find out how 3. much interest Shiela will pay for each unit. To do this, multiply the price of one unit ($150) by the interest rate (2%). So, $150 * 0.02 = $3.
        4. Now, let's calculate the total interest she will pay. Multiply the number of units (5) by the interest per unit ($3). So, 5 * $3 = $15. 5. Finally, add the initial cost without interest ($750) to the total interest paid ($15). This is the amount Shiela will pay for each month over the 3 months installment. So, $750 + $15 = $765.",Node39,1,2,5,7,0.9425668017609379,81,False
" 1. First, let's calculate the total cost of the cell phones without any interest. To do this, multiply the number of units (5) by the price per unit ($150). So, 5 * $150 = $750.
        2. Next, we need to find out how 3. much interest Shiela will pay for each unit. To do this, multiply the price of one unit ($150) by the interest rate (2%). So, $150 * 0.02 = $3.
        4. Now, let's calculate the total interest she will pay. Multiply the number of units (5) by the interest per unit ($3). So, 5 * $3 = $15. 5. Finally, add the total cost without interest ($750) to the total interest she will pay ($15). This gives us the final amount Shiela needs to pay for all 3 months. So, $750 + $15 = $765.",Node40,1,2,5,7,0.4563958314330502,108,False
" 1. First, let's calculate the total cost of the cell phones without any interest. To do this, multiply the number of units (5) by the price per unit ($150). So, 5 * $150 = $750.
        2. Next, we need to find out how 3. much interest Shiela will pay for each unit. To do this, multiply the price of one unit ($150) by the interest rate (2%). So, $150 * 0.02 = $3.
        4. Now, let's calculate the total interest she will pay. Multiply the number of units (5) by the interest per unit ($3). So, 5 * $3 = $15. 5. Finally, we need to add the total cost of cell phones without any interest ($750) with the total interest she will pay ($15). This gives us her overall cost which is $765.
        6. To divide this amount equally over 3 months, we'll need to find out how 7. much she should pay each month. Divide the total cost by the number of months (3). So, $765 / 3 = $255.
        Shiela will pay $255 each month for 3 months in installments.",Node42,0,0,5,5,0.42238572736482327,105,False
