continuation,Node Path,V Score,H Score,G Score,F Score,Temperature,Max Tokens,Wrong Solution Flag
" 1. First, let's determine the cost of each flower type. For the package of 3 flowers, we have 3 flowers per package and a total cost of $2.50 for that package. So, the cost per flower is $2.50 / 3 = $0.83.
        2. Similarly, for the package of 2 flowers, there are 2 flowers per package with a total cost of $1. The cost per flower here is $1 / 2 = $0.50.
        3. Now",Node3,1,3,1,4,0.37308319197715,118,False
" 1. First, let's determine the cost of each flower type. For the package of 3 flowers, we have 3 flowers per package and a total cost of $2.50 for that package. So, the cost per flower is $2.50 / 3 = $0.83.
        2. Similarly, for the package of 2 flowers, there are 2 flowers per package with a total cost of $1. The cost per flower here is $1 / 2 = $0.50.
        3. Now 4. Since Vincent wants to buy 18 flowers in total, we need to find the cheapest option: buying them in packages of either 3 or 2.
        5. To determine this, let's compare the cost per flower for both options. We have $0.8",Node7,5,5,6,11,0.6428602636984371,61,False
" 1. First, let's determine the cost of each flower type. For the package of 3 flowers, we have 3 flowers per package and a total cost of $2.50 for that package. So, the cost per flower is $2.50 / 3 = $0.83.
        2. Similarly, for the package of 2 flowers, there are 2 flowers per package with a total cost of $1. The cost per flower here is $1 / 2 = $0.50.
        3. Now 4. Let's identify the better price option based on the costs per flower. Comparing $0.83 to $0.50, Vincent saves more money when buying flowers at the $1 package (2 flowers) as it",Node8,5,4,6,10,0.6911810646288795,49,False
" 1. First, let's determine the cost of each flower type. For the package of 3 flowers, we have 3 flowers per package and a total cost of $2.50 for that package. So, the cost per flower is $2.50 / 3 = $0.83.
        2. Similarly, for the package of 2 flowers, there are 2 flowers per package with a total cost of $1. The cost per flower here is $1 / 2 = $0.50.
        3. Now 4. We want to compare these costs when buying 18 flowers. Let's calculate the total cost for each option:
        - Option A (package of 3): 18 flowers / 3 flowers per package = 6 packages, so the total",Node9,5,4,6,10,0.3289009329929524,55,False
" 1. First, let's determine the cost of each flower type. For the package of 3 flowers, we have 3 flowers per package and a total cost of $2.50 for that package. So, the cost per flower is $2.50 / 3 = $0.83.
        2. Similarly, for the package of 2 flowers, there are 2 flowers per package with a total cost of $1. The cost per flower here is $1 / 2 = $0.50.
        3. Now 4. To calculate how much money Vincent saves by buying 18 flowers at the better price, we need to identify the cheaper option first. Comparing the costs of individual flowers, it's",Node10,5,4,6,10,0.7478440691111404,40,False
" 1. First, let's determine the cost of each flower type. For the package of 3 flowers, we have 3 flowers per package and a total cost of $2.50 for that package. So, the cost per flower is $2.50 / 3 = $0.83.
        2. Similarly, for the package of 2 flowers, there are 2 flowers per package with a total cost of $1. The cost per flower here is $1 / 2 = $0.50.
        3. Now 4. Next, we need to find out which price is better for buying 18 flowers. Let's compare the costs of both types of packages: 
           - 18 flowers at $0.83 per flower (package of 3) = 18 * $0.83 = $15.04
           - 18 flowers at $0.50 per flower (package of 2) =",Node12,5,4,6,10,0.46022723929342735,93,False
" 1. First, let's determine the cost of each flower type. For the package of 3 flowers, we have 3 flowers per package and a total cost of $2.50 for that package. So, the cost per flower is $2.50 / 3 = $0.83.
        2. Similarly, for the package of 2 flowers, there are 2 flowers per package with a total cost of $1. The cost per flower here is $1 / 2 = $0.50.
        3. Now 4. Calculate Vincent's total number of flowers: He wants to buy 18 flowers, so he would need 18 / 3 = 6 packages of three flowers and 18 / 2 = 9 packages of two flowers.
        5. Find the cost for each type of package: For the package of 3",Node13,3,3,4,7,0.9074991961336475,72,False
" 1. First, let's determine the cost of each flower type. For the package of 3 flowers, we have 3 flowers per package and a total cost of $2.50 for that package. So, the cost per flower is $2.50 / 3 = $0.83.
        2. Similarly, for the package of 2 flowers, there are 2 flowers per package with a total cost of $1. The cost per flower here is $1 / 2 = $0.50.
        3. Now 4. Calculate Vincent's total number of flowers: He wants to buy 18 flowers, so he would need 18 / 3 = 6 packages of three flowers and 18 / 2 = 9 packages of two flowers.
        5. Find the cost for each type of package: For the package of 3 6. Calculate the total cost for each flower type: Total cost for 6 packages of 3 flowers is 6 * $0.83 = $5.00, and total cost for 9 packages of 2 flowers is 9 * $0.50 = $4.50.
        7. Compare the costs to find the difference: The better price would be",Node14,2,8,6,14,0.21137463685683522,83,False
" 1. First, let's determine the cost of each flower type. For the package of 3 flowers, we have 3 flowers per package and a total cost of $2.50 for that package. So, the cost per flower is $2.50 / 3 = $0.83.
        2. Similarly, for the package of 2 flowers, there are 2 flowers per package with a total cost of $1. The cost per flower here is $1 / 2 = $0.50.
        3. Now 4. Calculate Vincent's total number of flowers: He wants to buy 18 flowers, so he would need 18 / 3 = 6 packages of three flowers and 18 / 2 = 9 packages of two flowers.
        5. Find the cost for each type of package: For the package of 3 6. Add up the total cost for Vincent's chosen combinations: 6 * $0.83 (for the packages of 3) + 9 * $0.50 (for the packages of 2). This gives us a total of $4.98.
        7. Calculate how much money Vincent saves by buying the cheaper flowers: We compare this to the original cost if he were to buy all packages of 3, which is 6 * $2.50 = $15. So, Vincent would",Node15,4,7,8,15,0.9239977580855602,113,False
" 1. First, let's determine the cost of each flower type. For the package of 3 flowers, we have 3 flowers per package and a total cost of $2.50 for that package. So, the cost per flower is $2.50 / 3 = $0.83.
        2. Similarly, for the package of 2 flowers, there are 2 flowers per package with a total cost of $1. The cost per flower here is $1 / 2 = $0.50.
        3. Now 4. Calculate Vincent's total number of flowers: He wants to buy 18 flowers, so he would need 18 / 3 = 6 packages of three flowers and 18 / 2 = 9 packages of two flowers.
        5. Find the cost for each type of package: For the package of 3 6. Calculate Vincent's total savings by choosing the better price: First, let's find out how much he would spend if he bought all flowers at the $0.83 per flower rate from the packages of 3. That would be 18 * 0.83 = $15.14. Then, let's calculate the cost",Node16,5,8,9,17,0.4908294461175827,77,False
" 1. First, let's determine the cost of each flower type. For the package of 3 flowers, we have 3 flowers per package and a total cost of $2.50 for that package. So, the cost per flower is $2.50 / 3 = $0.83.
        2. Similarly, for the package of 2 flowers, there are 2 flowers per package with a total cost of $1. The cost per flower here is $1 / 2 = $0.50.
        3. Now 4. Calculate Vincent's total number of flowers: He wants to buy 18 flowers, so he would need 18 / 3 = 6 packages of three flowers and 18 / 2 = 9 packages of two flowers.
        5. Find the cost for each type of package: For the package of 3 5.1 Calculate the total cost by multiplying the number of packages (6) with the cost per flower ($0.83): 6 * $0.83 = $4.98.
        5.2 The cost for each of these packages is $2.50, so he would have 6 packages at a total cost of 6 * $2.50 = $15.
        6. For the package of 2:",Node17,3,8,7,15,0.8310453703499291,99,False
" 1. First, let's determine the cost of each flower type. For the package of 3 flowers, we have 3 flowers per package and a total cost of $2.50 for that package. So, the cost per flower is $2.50 / 3 = $0.83.
        2. Similarly, for the package of 2 flowers, there are 2 flowers per package with a total cost of $1. The cost per flower here is $1 / 2 = $0.50.
        3. Now 4. Calculate Vincent's total number of flowers: He wants to buy 18 flowers, so he would need 18 / 3 = 6 packages of three flowers and 18 / 2 = 9 packages of two flowers.
        5. Find the cost for each type of package: For the package of 3 6. Calculate the total cost for both types of packages: The cost for the 6 packages of 3 flowers is 6 * $0.83 = $5.00, and the",Node20,6,8,10,18,0.09729221249381648,42,False
" 1. First, let's determine the cost of each flower type. For the package of 3 flowers, we have 3 flowers per package and a total cost of $2.50 for that package. So, the cost per flower is $2.50 / 3 = $0.83.
        2. Similarly, for the package of 2 flowers, there are 2 flowers per package with a total cost of $1. The cost per flower here is $1 / 2 = $0.50.
        3. Now 4. Let's identify the better price option based on the costs per flower. Comparing $0.83 to $0.50, Vincent saves more money when buying flowers at the $1 package (2 flowers) as it 4. Finally, Vincent wants to buy 18 flowers in total. To determine which price gives him a better deal, we need to compare the cost of 18 flowers from each option. For the package of 3 flowers, he needs 18 / 3 = 6 packages, which costs 6 * $2.50 = $15. On the other hand, for the package of 2 flowers, he only needs 18 / 2 = 9 packages, and the total cost would be 9 * $1 = $9",Node21,2,1,8,9,0.6781918966739189,117,False
" 1. First, let's determine the cost of each flower type. For the package of 3 flowers, we have 3 flowers per package and a total cost of $2.50 for that package. So, the cost per flower is $2.50 / 3 = $0.83.
        2. Similarly, for the package of 2 flowers, there are 2 flowers per package with a total cost of $1. The cost per flower here is $1 / 2 = $0.50.
        3. Now 4. Let's identify the better price option based on the costs per flower. Comparing $0.83 to $0.50, Vincent saves more money when buying flowers at the $1 package (2 flowers) as it 5. Finally, we need to determine how many flowers Vincent needs to buy to reach 18 in total. Since we're using the cheaper option of $0.50 per flower, we can calculate this by dividing the total number of flowers needed (18) by the number of flowers per package (2). So, 18 / 2 = 9 packages are required for Vincent to buy 18 flowers.
        6. To find out how much money Vincent saves, multiply the number of packages (9) by the cost",Node22,3,2,9,11,0.5476058569183715,115,False
" 1. First, let's determine the cost of each flower type. For the package of 3 flowers, we have 3 flowers per package and a total cost of $2.50 for that package. So, the cost per flower is $2.50 / 3 = $0.83.
        2. Similarly, for the package of 2 flowers, there are 2 flowers per package with a total cost of $1. The cost per flower here is $1 / 2 = $0.50.
        3. Now 4. Let's identify the better price option based on the costs per flower. Comparing $0.83 to $0.50, Vincent saves more money when buying flowers at the $1 package (2 flowers) as it 5. Finally, let's calculate how much Vincent saves by buying 18 flowers in total. Since he buys 9 packages of 2 flowers ($1 per package), the cost for these is 9 * $1 = $9. For the remaining 9 flowers (",Node23,3,2,9,11,0.3845479430608799,58,False
" 1. First, let's determine the cost of each flower type. For the package of 3 flowers, we have 3 flowers per package and a total cost of $2.50 for that package. So, the cost per flower is $2.50 / 3 = $0.83.
        2. Similarly, for the package of 2 flowers, there are 2 flowers per package with a total cost of $1. The cost per flower here is $1 / 2 = $0.50.
        3. Now 4. Let's identify the better price option based on the costs per flower. Comparing $0.83 to $0.50, Vincent saves more money when buying flowers at the $1 package (2 flowers) as it 5. Calculate the total number of flowers needed. Vincent wants 18 flowers, so either 18 / 3 = 6 packages of three-flowers or 18 / 2 = 9 packages of two-flowers are necessary.
        6. Determine how much money Vincent saves by buying at",Node24,3,2,9,11,0.9493681323418844,68,False
" 1. First, let's determine the cost of each flower type. For the package of 3 flowers, we have 3 flowers per package and a total cost of $2.50 for that package. So, the cost per flower is $2.50 / 3 = $0.83.
        2. Similarly, for the package of 2 flowers, there are 2 flowers per package with a total cost of $1. The cost per flower here is $1 / 2 = $0.50.
        3. Now 4. Let's identify the better price option based on the costs per flower. Comparing $0.83 to $0.50, Vincent saves more money when buying flowers at the $1 package (2 flowers) as it 5. Finally, let's calculate how much money Vincent will save by purchasing 18 flowers at the better price. He needs to buy 18 flowers / 2 = 9 packages",Node26,5,4,11,15,0.44440813466513396,40,False
" 1. First, let's determine the cost of each flower type. For the package of 3 flowers, we have 3 flowers per package and a total cost of $2.50 for that package. So, the cost per flower is $2.50 / 3 = $0.83.
        2. Similarly, for the package of 2 flowers, there are 2 flowers per package with a total cost of $1. The cost per flower here is $1 / 2 = $0.50.
        3. Now 4. Let's identify the better price option based on the costs per flower. Comparing $0.83 to $0.50, Vincent saves more money when buying flowers at the $1 package (2 flowers) as it 4. Lastly, Vincent wants to buy 18 flowers, so let's find out how many packages of each type he needs to purchase. For the $0.83 per flower option, we need 18 / 3 = 6 packages of three",Node27,2,1,8,9,0.8291900234843463,56,False
" 1. First, let's determine the cost of each flower type. For the package of 3 flowers, we have 3 flowers per package and a total cost of $2.50 for that package. So, the cost per flower is $2.50 / 3 = $0.83.
        2. Similarly, for the package of 2 flowers, there are 2 flowers per package with a total cost of $1. The cost per flower here is $1 / 2 = $0.50.
        3. Now 4. Let's identify the better price option based on the costs per flower. Comparing $0.83 to $0.50, Vincent saves more money when buying flowers at the $1 package (2 flowers) as it 4. Finally, Vincent wants to buy 18 flowers in total. To determine which price gives him a better deal, we need to compare the cost of 18 flowers from each option. For the package of 3 flowers, he needs 18 / 3 = 6 packages, which costs 6 * $2.50 = $15. On the other hand, for the package of 2 flowers, he only needs 18 / 2 = 9 packages, and the total cost would be 9 * $1 = $9 5. So, Vincent saves $6 ($15 - $9) by buying flowers at the better price (package of 2).",Node28,1,0,9,9,0.6199931687830094,65,False
